,participant,word_count,start,end,duration
0,FA1,2,24039,25719,1680
1,FA1,2,27329,29409,2080
2,CHI,0,28829,29329,500
3,FA1,1,29764,30304,540
4,FA1,1,31629,32179,550
5,CHI,0,33276,33746,470
6,FA1,1,34171,34791,620
7,FA1,2,38406,38806,400
8,FA1,6,40806,41656,850
9,FA1,7,42511,44151,1640
10,FA1,1,45581,46441,860
11,CHI,0,46444,47464,1020
12,FA1,6,47626,49226,1600
13,CHI,0,49904,50324,420
14,FA1,3,50669,52759,2090
15,CHI,0,52359,52749,390
16,FA1,1,53129,53489,360
17,CHI,0,54654,55034,380
18,FA1,1,55174,55764,590
19,CHI,1,56159,56479,320
20,FA1,1,56524,57324,800
21,CHI,0,57284,57714,430
22,FA1,1,57924,58834,910
23,CHI,0,59284,59814,530
24,FA1,5,60621,62191,1570
25,CHI,0,61529,61949,420
26,FA1,1,62254,62624,370
27,CHI,0,63634,64094,460
28,FA1,1,64209,64809,600
29,CHI,0,64974,65484,510
30,FA1,1,65554,66304,750
31,CHI,0,68244,68634,390
32,FA1,1,68804,69394,590
33,CHI,0,69664,70094,430
34,FA1,1,70404,71044,640
35,CHI,0,72499,73049,550
36,FA1,1,73189,73829,640
37,CHI,0,74224,74614,390
38,FA1,1,74774,75454,680
39,CHI,0,75589,76769,1180
40,CHI,0,77194,78644,1450
41,FA1,5,79271,79751,480
42,CHI,0,80919,82659,1740
43,FA1,1,82734,83254,520
44,CHI,0,83299,86329,3030
45,FA1,1,84219,86149,1930
46,FA1,19,87076,91116,4040
47,CHI,0,88214,91134,2920
48,CHI,0,91529,92699,1170
49,FA1,1,92779,93349,570
50,CHI,0,93819,98149,4330
51,FA1,7,95009,97139,2130
52,FA1,1,97391,97901,510
53,FA1,3,98616,99766,1150
54,FA1,1,100486,100916,430
55,FA1,2,103801,104151,350
56,FA1,1,107471,107671,200
57,FA1,1,108591,108901,310
58,FA1,5,109526,110866,1340
59,CHI,0,111464,111864,400
60,FA1,5,112026,113586,1560
61,CHI,0,114109,114579,470
62,FA1,5,114609,116779,2170
63,CHI,0,117269,119749,2480
64,FA1,1,118046,118656,610
65,FA1,2,119804,121164,1360
66,CHI,0,122259,122419,160
67,FA1,8,123074,125054,1980
68,FA1,8,127321,129541,2220
69,FA1,3,133004,134764,1760
70,FA1,4,136969,141969,5000
71,FA1,4,144804,146964,2160
72,FA1,5,148861,150561,1700
73,FA1,5,152001,154541,2540
74,FA1,3,158799,160119,1320
75,FA1,4,163706,165526,1820
76,CHI,0,163706,165526,1820
77,FA1,6,166626,168446,1820
78,FA1,1,170051,170581,530
79,FA1,8,174316,176606,2290
80,FA1,3,186421,187091,670
81,CHI,0,186984,187884,900
82,FA1,1,187991,188341,350
83,CHI,0,188544,188874,330
84,CHI,1,190869,191479,610
85,CHI,0,192689,197219,4530
86,FA1,5,194376,195596,1220
87,FA1,1,197501,197681,180
88,FA1,1,199406,199516,110
89,FA1,8,203604,206424,2820
90,FA1,2,206786,207546,760
91,CHI,0,208716,210366,1650
92,FA1,2,208726,209116,390
93,FA1,1,211779,213259,1480
94,CHI,0,212844,213764,920
95,FA1,1,214896,215086,190
96,CHI,0,218494,221224,2730
97,FA1,7,219706,221076,1370
98,FA1,1,221699,222639,940
99,FA1,3,223124,224104,980
100,CHI,0,223464,224204,740
101,CHI,0,224519,225179,660
102,FA1,4,224551,225341,790
103,FA1,3,225874,228204,2330
104,FA1,5,229004,230324,1320
105,FA1,4,230539,231439,900
106,CHI,0,231714,232264,550
107,FA1,7,232814,235194,2380
108,CHI,0,234109,234629,520
109,FA1,7,236111,237631,1520
110,CHI,0,236484,237894,1410
111,CHI,0,238691,239211,520
112,FA1,6,240131,241061,930
113,CHI,0,241364,243014,1650
114,FA1,3,243096,244346,1250
115,CHI,0,244674,245914,1240
116,FA1,1,245961,246781,820
117,FA1,1,248874,249714,840
118,CHI,0,255616,256116,500
119,FA1,4,256596,257266,670
120,FA1,1,257591,257781,190
121,CHI,0,258126,258616,490
122,FA1,6,258981,260421,1440
123,FA1,4,264971,265711,740
124,CHI,0,266241,267031,790
125,FA1,7,267181,268101,920
126,FA1,7,268601,269311,710
127,CHI,0,271176,271506,330
128,FA1,8,271694,274504,2810
129,FA1,1,275891,277141,1250
130,CHI,0,277876,278106,230
131,FA1,1,278691,278991,300
132,CHI,0,280691,281011,320
133,FA1,6,281361,283771,2410
134,FA1,2,284986,285826,840
135,CHI,0,287554,288344,790
136,CHI,0,289121,289451,330
137,FA1,1,289846,291126,1280
138,CHI,0,292179,293459,1280
139,CHI,0,294521,295641,1120
140,FA1,4,296366,297356,990
141,CHI,0,297029,298049,1020
142,FA1,4,298194,299094,900
143,CHI,0,298921,299571,650
144,FA1,5,299796,300596,800
145,CHI,0,302086,307966,5880
146,FA1,2,302976,304096,1120
147,FA1,9,305116,307986,2870
148,CHI,0,309061,310651,1590
149,FA1,2,311386,311726,340
150,CHI,0,313604,315784,2180
151,CHI,0,316069,317789,1720
152,FA1,2,317824,318664,840
153,CHI,0,319139,320829,1690
154,FA1,9,320989,323719,2730
155,FA1,9,325701,327151,1450
156,FA1,8,328314,330454,2140
157,CHI,0,329906,330336,430
158,FA1,3,332081,333061,980
159,FA1,4,334731,335501,770
160,FA1,1,337376,337596,220
161,FA1,10,339646,341366,1720
162,CHI,0,341186,346916,5730
163,FA1,10,342731,344971,2240
164,FA1,4,346581,347781,1200
165,FA1,7,348765,355815,7050
166,CHI,0,355550,356400,850
167,FA1,1,357435,357915,480
168,FA1,5,359115,360405,1290
169,CHI,0,361175,362015,840
170,FA1,5,363465,364415,950
171,CHI,0,365220,365880,660
172,FA1,1,366220,367480,1260
173,CHI,0,368020,368350,330
174,FA1,0,370345,371145,800
175,CHI,0,371595,371865,270
176,CHI,0,373660,374150,490
177,CHI,0,374985,375405,420
178,FA1,7,375645,377105,1460
179,FA1,5,378385,379385,1000
180,CHI,1,383805,384465,660
181,FA1,2,384975,385525,550
182,FA1,2,386870,387590,720
183,FA1,6,390445,392175,1730
184,FA1,2,392880,393310,430
185,FA1,2,395160,395490,330
186,CHI,0,398594,398994,400
187,FA1,1,399745,400665,920
188,FA1,4,401655,402485,830
189,FA1,1,403000,403450,450
190,FA1,6,404515,405705,1190
191,FA1,7,406210,407900,1690
192,CHI,0,407051,408001,950
193,FA1,4,409605,410745,1140
194,CHI,0,414035,414485,450
195,FA1,4,415410,416240,830
196,CHI,0,418295,419195,900
197,FA1,4,420565,421305,740
198,FA1,2,424665,425035,370
199,FA1,4,425940,426910,970
200,FA1,6,429615,431295,1680
201,CHI,0,434145,434755,610
202,FA1,1,435830,436360,530
203,FA1,1,437715,438185,470
204,CHI,0,439004,439914,910
205,FA1,1,439885,440265,380
206,FA1,6,441574,443184,1610
207,FA1,5,444544,446764,2220
208,CHI,0,446885,447705,820
209,FA1,1,448225,448855,630
210,CHI,0,449495,450115,620
211,FA1,8,450464,452984,2520
212,CHI,0,456769,457819,1050
213,FA1,3,457830,458610,780
214,CHI,0,459309,459829,520
215,CHI,0,460074,461114,1040
216,FA1,1,461339,461689,350
217,CHI,0,461949,463689,1740
218,CHI,0,464014,465204,1190
219,CHI,0,465485,466185,700
220,FA1,2,466484,467564,1080
221,CHI,0,467699,468299,600
222,CHI,0,468754,471644,2890
223,FA1,11,468790,471410,2620
224,FA1,3,472020,473120,1100
225,CHI,0,473600,474110,510
226,FA1,6,475605,476725,1120
227,CHI,0,476339,479919,3580
228,FA1,7,481260,482800,1540
229,CHI,0,483840,489160,5320
230,FA1,15,485764,489204,3440
231,CHI,0,489969,491729,1760
232,FA1,6,492724,493774,1050
233,FA1,6,493814,494834,1020
234,CHI,0,494115,495755,1640
235,FA1,3,495755,496495,740
236,FA1,8,496684,498844,2160
237,CHI,0,499159,511299,12140
238,FA1,6,500345,502385,2040
239,FA1,6,503834,507064,3230
240,FA1,2,509090,510940,1850
241,FA1,1,512004,512484,480
242,CHI,0,513019,513899,880
243,CHI,0,514334,515764,1430
244,CHI,0,516834,517484,650
245,FA1,1,520770,521150,380
246,CHI,0,521639,530729,9090
247,FA1,8,522460,524150,1690
248,FA1,7,524805,526755,1950
249,FA1,9,527310,529760,2450
250,FA1,2,533125,533715,590
251,CHI,0,535374,536804,1430
252,FA1,1,536205,536745,540
253,FA1,1,541369,541729,360
254,FA1,4,542405,543345,940
255,FA1,1,544105,544345,240
256,CHI,0,545195,548115,2920
257,FA1,3,545895,546815,920
258,FA1,4,547815,549805,1990
259,CHI,0,549469,550429,960
260,FA1,1,550474,551504,1030
261,CHI,0,551594,556124,4530
262,FA1,3,553994,555274,1280
263,FA1,1,556429,556969,540
264,FA1,3,557765,558395,630
265,FA1,3,560430,561280,850
266,FA1,12,562235,564245,2010
267,FA1,4,565020,566230,1210
268,CHI,1,567425,573955,6530
269,CHI,0,575950,578400,2450
270,FA1,11,577545,581605,4060
271,CHI,0,579194,580744,1550
272,CHI,1,581645,582425,780
273,FA1,1,582845,583195,350
274,FA1,9,583510,585500,1990
275,FA1,5,590295,591955,1660
276,FA1,5,592680,593640,960
277,FA1,6,593690,595560,1870
278,FA1,5,597199,599029,1830
279,FA1,3,599630,600490,860
280,CHI,0,599839,603869,4030
281,FA1,11,602260,604530,2270
282,CHI,0,603869,611219,7350
283,FA1,6,606910,608100,1190
284,FA1,3,611595,612635,1040
285,CHI,0,613175,615985,2810
286,CHI,0,616449,619509,3060
287,FA1,7,617020,619090,2070
288,FA1,0,623624,624534,910
289,CHI,0,624839,625519,680
290,FA1,4,625710,626560,850
291,FA1,5,627364,628684,1320
292,CHI,0,628829,629609,780
293,FA1,5,630069,631709,1640
294,FA1,4,635105,635825,720
295,CHI,1,637169,637729,560
296,FA1,1,637959,638509,550
297,CHI,1,639145,639655,510
298,FA1,1,639675,640065,390
299,FA1,4,643300,644650,1350
300,CHI,0,644604,645724,1120
301,FA1,1,649590,650210,620
302,CHI,0,657465,659485,2020
303,FA1,5,659945,660725,780
304,FC1,3,660975,661895,920
305,FA1,10,661965,663515,1550
306,FC1,1,663535,663915,380
307,FA1,8,664370,666150,1780
308,FC1,1,666670,667080,410
309,FAE,10,668600,670700,2100
310,EE1,0,671949,672529,580
311,FA1,12,672570,675030,2460
312,FA1,9,675780,677350,1570
313,FC1,3,678315,678785,470
314,FC1,5,679770,680940,1170
315,FA1,11,681495,683745,2250
316,FC1,0,685864,687924,2060
317,CHI,0,687869,689269,1400
318,FA1,6,689465,691015,1550
319,FC1,0,695424,696954,1530
320,FA1,15,699510,702760,3250
321,FA1,4,704415,706435,2020
322,FA1,1,710375,711195,820
323,FC1,4,713996,715126,1130
324,FC1,3,715381,717631,2250
325,FC1,2,721319,722729,1410
326,FA1,7,723335,724485,1150
327,FA1,5,725580,727050,1470
328,FA1,17,727875,731975,4100
329,CHI,0,733775,736905,3130
330,FA1,6,734020,735880,1860
331,FA1,7,737640,739150,1510
332,FA1,6,739485,740285,800
333,FA1,1,742505,742725,220
334,CHI,0,743235,744285,1050
335,FAE,0,743939,746089,2150
336,FA1,1,746815,747655,840
337,FAE,0,747934,750434,2500
338,CHI,0,748000,749820,1820
339,CHI,0,750429,759829,9400
340,FA1,11,750840,753520,2680
341,FA1,6,754120,755800,1680
342,FC1,2,755854,757314,1460
343,FAE,4,760125,761655,1530
344,FC1,4,761660,762730,1070
345,FA1,3,762900,763830,930
346,FAE,10,766580,768580,2000
347,FA1,8,769690,772710,3020
348,FA1,23,773589,782039,8450
349,FA1,21,782765,787825,5060
350,FAE,2,788489,789189,700
351,FAE,13,790175,793645,3470
352,FA1,5,794465,797405,2940
353,FA1,7,798525,800985,2460
354,FAE,5,801594,804044,2450
355,FA1,8,804050,806360,2310
356,FA1,11,806935,809075,2140
357,FA1,11,809775,812635,2860
358,FA1,14,813045,816445,3400
359,FAE,6,817155,818865,1710
360,FAE,12,818995,821425,2430
361,FAE,10,821760,824010,2250
362,FA1,8,824475,826495,2020
363,FA1,1,827225,827475,250
364,FC1,8,827940,829690,1750
365,FA1,10,830135,832415,2280
366,FAE,2,832415,833015,600
367,FA1,14,833035,836475,3440
368,FAE,15,837055,839665,2610
369,FA1,30,840200,847910,7710
370,FA1,11,848235,850575,2340
371,FAE,0,850645,852515,1870
372,FA1,11,852770,855080,2310
373,FAE,11,855874,859514,3640
374,CHI,0,856245,856575,330
375,FC1,15,858470,862200,3730
376,FA1,9,861774,864124,2350
377,FAE,4,864555,865705,1150
378,FC1,5,865060,865740,680
379,FA1,11,865680,867530,1850
380,FAE,3,867655,868705,1050
381,FC1,11,868740,873070,4330
382,FA1,22,873425,878235,4810
383,FC1,5,878800,880530,1730
384,FA1,5,880635,881875,1240
385,FAE,17,882445,886445,4000
386,FAE,1,887985,888355,370
387,FC1,12,888649,893409,4760
388,FA1,21,893455,898115,4660
389,FC1,12,898360,903480,5120
390,CHI,0,901099,901569,470
391,FA1,11,904080,906800,2720
392,FAE,13,907490,910450,2960
393,CHI,0,912340,912770,430
394,FAE,9,913095,915455,2360
395,FAE,5,916044,918214,2170
396,FA1,1,916595,917595,1000
397,FAE,1,918214,919915,1701
398,FC1,1,920309,921669,1360
399,FAE,7,922100,925970,3870
400,CHI,0,923105,923575,470
401,FA1,1,927790,928810,1020
402,FAE,0,928570,929900,1330
403,FAE,4,930045,931935,1890
404,FAE,12,933260,935690,2430
405,FA1,1,936155,936435,280
406,FAE,10,936945,939525,2580
407,FA1,1,940105,940595,490
408,FAE,29,941380,952010,10630
409,FA1,2,952635,953725,1090
410,FAE,28,954076,961936,7860
411,FA1,32,962181,971071,8890
412,FAE,7,971600,973100,1500
413,FA1,3,973116,975276,2160
414,FAE,13,974675,978005,3330
415,FA1,10,978700,981110,2410
416,FAE,8,981330,982830,1500
417,FA1,1,982840,983260,420
418,FA1,2,983810,984800,990
419,FAE,6,985525,986625,1100
420,FA1,1,986715,987075,360
421,FA1,1,989385,990165,780
422,FAE,5,990815,992115,1300
423,FA1,1,992305,992445,140
424,CHI,0,995345,996145,800
425,FA1,6,997025,997985,960
426,CHI,0,998335,999135,800
427,FA1,2,999295,999795,500
428,FC1,2,1000405,1001445,1040
429,FA1,3,1001425,1002545,1120
430,FC1,7,1003085,1005605,2520
431,FA1,5,1005765,1007085,1320
432,CHI,0,1007626,1007916,290
433,EE1,4,1008675,1009895,1220
434,EE1,0,1010505,1011525,1020
435,EE1,1,1012115,1012695,580
436,EE1,5,1013115,1014515,1400
437,EE1,6,1014955,1017265,2310
438,EE1,5,1017820,1020810,2990
439,EE1,0,1021005,1022295,1290
440,EE1,3,1022990,1024710,1720
441,EE1,2,1026700,1030830,4130
442,EE1,5,1033695,1036515,2820
443,EE1,1,1036725,1039985,3260
444,EE1,2,1040095,1040695,600
445,EE1,2,1041795,1043115,1320
446,CHI,0,1043685,1043995,310
447,EE1,4,1044045,1047635,3590
448,FA1,1,1046320,1046980,660
449,FA1,14,1048570,1051360,2790
450,EE1,0,1051420,1056520,5100
451,CHI,0,1051745,1052185,440
452,FA1,5,1052665,1054255,1590
453,CHI,0,1055595,1055745,150
454,EE1,1,1056540,1057990,1450
455,CHI,0,1057590,1057910,320
456,EE1,4,1058595,1059805,1210
457,CHI,0,1058991,1059151,160
458,EE1,5,1060210,1062400,2190
459,CHI,0,1060370,1060680,310
460,EE1,6,1062535,1065515,2980
461,EE1,6,1065675,1068565,2890
462,CHI,0,1066005,1066225,220
463,CHI,0,1067301,1067421,120
464,CHI,0,1068951,1069131,180
465,EE1,4,1069125,1071885,2760
466,CHI,0,1070770,1071070,300
467,EE1,2,1073380,1075490,2110
468,FC1,6,1074365,1077275,2910
469,EE1,0,1075490,1097070,21580
470,FA1,1,1077340,1077950,610
471,FC1,11,1078886,1086236,7350
472,FA1,2,1079615,1081065,1450
473,FA1,3,1085695,1086495,800
474,FA1,24,1092205,1097365,5160
475,EE1,0,1097070,1114920,17850
476,FA1,15,1097605,1099825,2220
477,FA1,17,1102525,1107285,4760
478,CHI,0,1111045,1111355,310
479,EE1,3,1114925,1116435,1510
480,EE1,0,1116435,1128445,12010
481,CHI,0,1124475,1124815,340
482,EE1,0,1128450,1134715,6265
483,EE1,0,1134715,1149045,14330
484,CHI,0,1139475,1139705,230
485,CHI,0,1146680,1147000,320
486,FC1,11,1149040,1152280,3240
487,EE1,0,1149055,1163175,14120
488,FA1,10,1152280,1154670,2390
489,FA1,5,1155305,1155845,540
490,CHI,0,1156285,1157465,1180
491,FA1,1,1157755,1158375,620
492,FA1,3,1158835,1159635,800
493,FC1,3,1159665,1160735,1070
494,FC1,0,1161580,1162460,880
495,FA1,7,1162510,1165780,3270
496,EE1,0,1163189,1177710,14521
497,FC1,5,1168125,1170195,2070
498,FA1,15,1171475,1175795,4320
499,EE1,0,1177710,1184860,7150
500,FC1,1,1177845,1178125,280
501,FA1,4,1178615,1180415,1800
502,EE1,9,1184870,1187830,2960
503,FA1,5,1187555,1189085,1530
504,EE1,0,1187830,1191070,3240
505,EE1,3,1191070,1192800,1730
506,FC1,3,1192210,1193770,1560
507,EE1,0,1192820,1199500,6680
508,FA1,18,1194350,1199490,5140
509,EE1,7,1199511,1202021,2510
510,EE1,5,1202066,1204400,2334
511,FA1,7,1203540,1205130,1590
512,EE1,0,1204400,1231820,27420
513,FC1,5,1206095,1208845,2750
514,CHI,0,1209810,1210140,330
515,FA1,2,1210295,1211535,1240
516,FC1,8,1212185,1217455,5270
517,FA1,7,1217850,1220120,2270
518,FC1,1,1220615,1221235,620
519,CHI,0,1221995,1222415,420
520,CHI,0,1224975,1225365,390
521,FA1,7,1227080,1228880,1800
522,EE1,0,1231840,1246390,14550
523,EE1,0,1246399,1265010,18611
524,FA1,8,1248084,1251814,3730
525,FA1,7,1255210,1257400,2190
526,FA1,8,1258715,1260125,1410
527,EE1,0,1265010,1288000,22990
528,FC1,6,1267830,1269620,1790
529,EE1,0,1288025,1307995,19970
530,FA1,6,1304570,1306010,1440
531,CHI,0,1306034,1306954,920
532,FA1,2,1306920,1307850,930
533,EE1,0,1308000,1335000,27000
534,FA1,1,1308905,1309375,470
535,CHI,0,1316316,1317506,1190
536,FA1,9,1322140,1325420,3280
537,FA1,6,1328440,1329500,1060
538,FC1,8,1329980,1334390,4410
539,EE1,0,1335000,1343100,8100
540,FA1,11,1335354,1338954,3600
541,EE1,4,1343105,1345145,2040
542,FC1,1,1344470,1345110,640
543,EE1,0,1345169,1353458,8289
544,FC1,8,1346990,1350540,3550
545,FA1,6,1350684,1353424,2740
546,EE1,0,1353458,1367708,14250
547,CHI,0,1365125,1365285,160
548,EE1,5,1367708,1369320,1612
549,EE1,7,1369975,1371245,1270
550,EE1,7,1372540,1375480,2940
551,EE1,0,1375503,1385423,9920
552,FC1,5,1376895,1378705,1810
553,FA1,20,1379430,1383450,4020
554,FC1,0,1384834,1385544,710
555,EE1,0,1385443,1426213,40770
556,FC1,9,1386764,1391604,4840
557,FA1,1,1392264,1393744,1480
558,FC1,0,1394719,1397859,3140
559,FA1,3,1398180,1400420,2240
560,FC1,6,1399894,1402664,2770
561,FA1,10,1402710,1406220,3510
562,FC1,11,1402710,1406220,3510
563,FA1,13,1406515,1410415,3900
564,FA1,16,1410495,1413835,3340
565,FA1,11,1416035,1419025,2990
566,FC1,2,1420784,1421984,1200
567,FC1,2,1424115,1424905,790
568,FC1,2,1425499,1426159,660
569,FA1,4,1426195,1427515,1320
570,EE1,0,1426221,1430991,4770
571,EE1,2,1431001,1432401,1400
572,EE1,0,1432406,1440016,7610
573,FA1,6,1439620,1441130,1510
574,EE1,0,1440029,1449419,9390
575,FC1,1,1442150,1442800,650
576,FA1,1,1443195,1444025,830
577,FC1,4,1443515,1444485,970
578,FA1,11,1444790,1448250,3460
579,EE1,4,1449419,1451266,1847
580,FC1,1,1449695,1450705,1010
581,EE1,6,1451441,1453601,2160
582,EE1,0,1453601,1456031,2430
583,EE1,0,1456031,1460081,4050
584,CHI,0,1458071,1458611,540
585,CHI,0,1459631,1459871,240
586,FA1,1,1461270,1462280,1010
587,FA1,11,1463625,1467565,3940
588,FC1,2,1469065,1469885,820
589,FA1,2,1470495,1471795,1300
590,FA1,1,1475745,1476485,740
591,FA1,1,1491565,1491735,170
592,EE1,0,1495540,1520000,24460
593,FC1,4,1495550,1497120,1570
594,FC1,3,1497540,1498730,1190
595,FA1,6,1500075,1501865,1790
596,CHI,0,1506820,1507180,360
597,EE1,0,1520000,1555010,35010
598,FA1,1,1520240,1521200,960
599,EE1,0,1555015,1580000,24985
600,CHI,0,1570765,1571065,300
601,EE1,0,1580015,1598565,18550
602,CHI,0,1580445,1581205,760
603,FA1,23,1581665,1589145,7480
604,FC1,1,1591555,1592055,500
605,FA1,8,1594195,1595885,1690
606,FC1,1,1596235,1596705,470
607,FA1,5,1596920,1598830,1910
608,EE1,0,1598565,1616275,17710
609,FC1,10,1603690,1608540,4850
610,FA1,12,1608845,1612975,4130
611,EE1,0,1616275,1654985,38710
612,CHI,0,1616280,1616710,430
613,FC1,1,1617220,1617720,500
614,FC1,9,1620935,1624395,3460
615,FA1,9,1625055,1628255,3200
616,FC1,4,1635000,1637780,2780
617,FC1,0,1640470,1642200,1730
618,FC1,0,1642465,1646265,3800
619,CHI,0,1647300,1647720,420
620,CHI,0,1648840,1649020,180
621,EE1,0,1655005,1675005,20000
622,EE1,0,1675015,1691305,16290
623,FA1,4,1677850,1678830,980
624,FC1,1,1678830,1679180,350
625,FA1,1,1679345,1679735,390
626,FC1,3,1690195,1691295,1100
627,EE1,0,1691620,1719980,28360
628,FA1,6,1692000,1693490,1490
629,CHI,0,1704130,1704320,190
630,CHI,0,1719870,1720110,240
631,EE1,0,1720000,1750010,30010
632,CHI,0,1721855,1722105,250
633,CHI,0,1724490,1724830,340
634,FA1,8,1746730,1749660,2930
635,EE1,0,1750020,1770020,20000
636,FC1,1,1752505,1753185,680
637,FA1,3,1753735,1754595,860
638,FC1,5,1756795,1757995,1200
639,FA1,4,1759165,1759835,670
640,FC1,0,1760315,1761275,960
641,FA1,4,1762025,1762615,590
642,FC1,0,1763005,1763355,350
643,FA1,12,1763470,1765900,2430
644,FA1,6,1768490,1769760,1270
645,CHI,0,1769100,1769960,860
646,FA1,1,1770115,1770525,410
647,CHI,0,1771220,1771800,580
648,FC1,6,1787065,1788505,1440
649,FA1,1,1788755,1789405,650
650,FA1,6,1790320,1792000,1680
651,FC1,10,1791580,1794910,3330
652,FA1,3,1795095,1796065,970
653,FA1,1,1796640,1796790,150
654,FA1,5,1799010,1800380,1370
655,FA1,4,1802255,1803725,1470
656,FA1,5,1805200,1806330,1130
657,FC1,3,1807575,1809015,1440
658,FA1,7,1809165,1810835,1670
659,FA1,15,1815690,1818390,2700
660,FC1,2,1819555,1819895,340
661,FA1,7,1820265,1821445,1180
662,FC1,1,1825090,1825810,720
663,FA1,8,1826465,1828195,1730
664,FC1,0,1827410,1828770,1360
665,FA1,2,1829580,1830330,750
666,FA1,5,1833700,1835480,1780
667,CHI,0,1835260,1836380,1120
668,FA1,5,1836490,1837730,1240
669,CHI,1,1836970,1837740,770
670,FA1,1,1837865,1838705,840
671,FC1,4,1838815,1840325,1510
672,FC1,2,1842400,1843720,1320
673,FA1,1,1842890,1843670,780
674,FA1,3,1843810,1845040,1230
675,CHI,0,1846305,1846665,360
676,FA1,9,1846980,1850230,3250
677,FC1,4,1851505,1853505,2000
678,FA1,14,1853825,1856875,3050
679,FC1,3,1857670,1859090,1420
680,FA1,6,1859880,1862450,2570
681,CHI,1,1861455,1862485,1030
682,FA1,8,1863060,1864980,1920
683,FC1,5,1864990,1866590,1600
684,FA1,11,1867530,1870710,3180
685,CHI,0,1873060,1873830,770
686,FA1,2,1873445,1875045,1600
687,FA1,12,1876765,1879215,2450
688,CHI,0,1879790,1880130,340
689,FA1,1,1880610,1880770,160
690,FA1,3,1882500,1884250,1750
691,CHI,0,1883460,1883850,390
692,FA1,3,1886185,1887305,1120
693,FC1,2,1887810,1888630,820
694,FA1,3,1891525,1892575,1050
695,CHI,0,1892350,1893010,660
696,FA1,1,1893330,1893620,290
697,FA1,2,1894925,1895805,880
698,FA1,4,1896225,1897145,920
699,CHI,0,1898370,1898670,300
700,FA1,2,1900630,1901260,630
701,FA1,2,1902805,1903615,810
702,CHI,0,1903980,1905220,1240
703,CHI,0,1908120,1908490,370
704,FA1,1,1908965,1909505,540
705,FA1,6,1910235,1911355,1120
706,FA1,1,1911745,1912445,700
707,FC1,1,1912675,1913185,510
708,FA1,1,1913110,1913820,710
709,CHI,0,1914955,1915235,280
710,FA1,2,1915625,1916285,660
711,FC1,4,1918025,1919755,1730
712,CHI,0,1919155,1919735,580
713,FA1,1,1920927,1921217,290
714,FC1,7,1921132,1924172,3040
715,FA1,6,1924142,1925942,1800
716,FA1,7,1926576,1928611,2035
717,FA1,5,1929017,1929897,880
718,FA1,4,1931807,1932467,660
719,FA1,4,1933797,1935017,1220
720,CHI,0,1936752,1937382,630
721,FC1,5,1938026,1940596,2570
722,CHI,0,1940972,1942042,1070
723,FA1,14,1942972,1947592,4620
724,FC1,2,1947862,1948552,690
725,FA1,10,1948967,1951717,2750
726,FA1,16,1952112,1955032,2920
727,FC1,1,1955102,1956002,900
728,FA1,8,1956102,1957922,1820
729,FC1,4,1958032,1960412,2380
730,FA1,10,1961290,1964639,3349
731,FC1,1,1966782,1967062,280
732,FC1,14,1971822,1975672,3850
733,FA1,16,1976117,1979537,3420
734,FC1,6,1980857,1982547,1690
735,FA1,17,1982802,1987462,4660
736,FA1,20,1988262,1992502,4240
737,FA1,21,1993982,1998092,4110
738,FA1,16,1998697,2002407,3710
739,FC1,1,2003692,2004382,690
740,FA1,1,2004087,2004557,470
741,FC1,6,2005687,2008217,2530
742,FA1,1,2008597,2009267,670
743,FA1,4,2009662,2010742,1080
744,FC1,1,2011197,2015535,4338
745,FA1,6,2016657,2020237,3580
746,FA1,7,2020507,2024097,3590
747,FC1,4,2025247,2026827,1580
748,FA1,6,2029471,2031785,2314
749,FA1,8,2032622,2034132,1510
750,FC1,2,2041137,2042807,1670
751,FC1,5,2043842,2046462,2620
752,FC1,2,2048130,2050060,1930
753,FA1,2,2050655,2051755,1100
754,FC1,6,2052435,2054835,2400
755,FC1,4,2055805,2058295,2490
756,FC1,4,2058840,2061420,2580
757,FC1,0,2061780,2063260,1480
758,FC1,4,2066630,2069020,2390
759,FA1,3,2069145,2070195,1050
760,FC1,6,2070525,2077405,6880
761,FC1,11,2077465,2083305,5840
762,FA1,6,2083565,2085615,2050
763,FC1,5,2086085,2088395,2310
764,FA1,14,2089800,2093870,4070
765,FC1,5,2094225,2101125,6900
766,FA1,7,2101875,2104335,2460
767,FC1,0,2104095,2105745,1650
768,FC1,0,2106520,2112080,5560
769,FA1,26,2112180,2120090,7910
770,FC1,1,2121175,2122545,1370
771,FA1,2,2121910,2122540,630
772,FA1,2,2129355,2129935,580
773,FA1,10,2130405,2132605,2200
774,CHI,0,2131290,2131810,520
775,FA1,4,2133855,2134625,770
776,CHI,0,2135430,2135700,270
777,FA1,2,2136105,2136395,290
778,CHI,0,2137860,2138370,510
779,FC1,4,2162085,2164245,2160
780,FA1,1,2172175,2172495,320
781,FA1,3,2175525,2176235,710
782,FC1,1,2177035,2177295,260
783,FA1,1,2177635,2177985,350
784,CHI,1,2178350,2178700,350
785,FA1,1,2179095,2179345,250
786,FA1,3,2189490,2190400,910
787,CHI,0,2190535,2191565,1030
788,FA1,5,2198450,2199740,1290
789,CHI,0,2201215,2201695,480
790,CHI,0,2204365,2204655,290
791,CHI,0,2206560,2207110,550
792,FA1,1,2212165,2212355,190
793,FC1,4,2212970,2214630,1660
794,CHI,0,2215560,2216000,440
795,FC1,3,2216130,2217310,1180
796,FA1,6,2217470,2218610,1140
797,FA1,4,2228080,2228860,780
798,CHI,0,2249920,2250370,450
799,FA1,1,2250625,2250805,180
800,FA1,5,2253095,2254445,1350
801,CHI,0,2254800,2255130,330
802,FA1,13,2255585,2257785,2200
803,FC1,4,2259005,2260405,1400
804,FA1,3,2260935,2261695,760
805,FC1,4,2262205,2263215,1010
806,FA1,3,2263710,2264200,490
807,FA1,2,2267065,2267625,560
808,FA1,5,2268075,2269075,1000
809,CHI,0,2275685,2276045,360
810,FA1,1,2276375,2276725,350
811,FA1,9,2277650,2279250,1600
812,FA1,5,2280715,2282545,1830
813,FA1,3,2284730,2285940,1210
814,FA1,8,2286825,2288655,1830
815,FC1,1,2289185,2289365,180
816,FA1,6,2290565,2291805,1240
817,FA1,1,2292575,2292775,200
818,FC1,13,2292925,2297735,4810
819,FA1,3,2298935,2300737,1802
820,FC1,7,2300520,2302720,2200
821,FA1,1,2303010,2303540,530
822,FC1,5,2303545,2306005,2460
823,FA1,1,2306285,2306725,440
824,FA1,9,2307295,2309455,2160
825,FC1,2,2310666,2312515,1849
826,FA1,1,2312755,2313065,310
827,FA1,7,2314380,2315610,1230
828,FA1,9,2321535,2325115,3580
829,CHI,0,2326165,2326485,320
830,FA1,1,2326825,2327045,220
831,CHI,0,2328445,2328695,250
832,FA1,5,2330040,2331410,1370
833,FA1,13,2333775,2339995,6220
834,FA1,5,2343225,2344635,1410
835,CHI,0,2345090,2345860,770
836,FA1,5,2346185,2347695,1510
837,FA1,7,2352710,2354560,1850
838,FA1,10,2363865,2365835,1970
839,FA1,1,2367780,2368380,600
840,FA1,3,2373760,2374370,610
841,CHI,0,2374595,2375335,740
842,FA1,10,2375415,2377085,1670
843,CHI,0,2376900,2377720,820
844,FA1,6,2377720,2379700,1980
845,FA1,6,2379850,2381290,1440
846,FA1,1,2382650,2382780,130
847,FA1,5,2383665,2384665,1000
848,FA1,9,2392590,2396350,3760
849,FA1,5,2412620,2414290,1670
850,FA1,4,2416445,2417475,1030
851,FA1,0,2420204,2423739,3535
852,CHI,0,2423035,2423686,651
853,FA1,1,2423995,2424295,300
854,FA1,10,2425855,2428595,2740
855,FA1,7,2430755,2432455,1700
856,CHI,0,2430909,2431851,942
857,FA1,4,2433225,2434035,810
858,CHI,0,2435430,2436200,770
859,FA1,1,2436415,2436775,360
860,FA1,1,2439492,2440213,721
861,CHI,0,2439857,2441334,1477
862,FA1,1,2441550,2442850,1300
863,FA1,5,2442860,2444290,1430
864,FA1,14,2447665,2451485,3820
865,FA1,4,2459245,2460535,1290
866,FC1,2,2461090,2461480,390
867,FA1,2,2461815,2462265,450
868,FA1,1,2463107,2463502,395
869,FA1,5,2464020,2464970,950
870,FC1,2,2465215,2466385,1170
871,FA1,2,2467190,2467920,730
872,FA1,4,2468635,2469525,890
873,FA1,5,2471110,2471960,850
874,FA1,1,2474435,2475755,1320
875,FA1,2,2476205,2478335,2130
876,CHI,0,2477040,2478310,1270
877,FC1,3,2478330,2478910,580
878,FA1,5,2478970,2481040,2070
879,FC1,5,2480785,2482205,1420
880,FA1,5,2482205,2483715,1510
881,FC1,3,2483680,2486080,2400
882,FA1,7,2486130,2488410,2280
883,FC1,4,2488990,2490490,1500
884,FA1,8,2490820,2493980,3160
885,FC1,1,2495745,2496165,420
886,FA1,7,2496895,2498155,1260
887,FC1,2,2498635,2501255,2620
888,FA1,10,2501265,2504345,3080
889,FC1,6,2504695,2508045,3350
890,FA1,1,2508095,2509395,1300
891,CHI,0,2510640,2511690,1050
892,CHI,0,2511735,2512095,360
893,FC1,0,2512445,2512805,360
894,FC1,2,2513665,2516205,2540
895,CHI,0,2514355,2514715,360
896,FA1,5,2516654,2518306,1652
897,FC1,7,2516825,2519325,2500
898,FA1,5,2518785,2520075,1290
899,FC1,3,2521200,2525390,4190
900,FA1,5,2525615,2527375,1760
901,FA1,15,2528155,2532225,4070
902,FC1,6,2532210,2535360,3150
903,FA1,10,2535315,2536925,1610
904,FC1,4,2536200,2537790,1590
905,FA1,6,2538045,2540545,2500
906,FC1,1,2540565,2541085,520
907,FC1,2,2541695,2542935,1240
908,FA1,11,2543835,2546235,2400
909,FC1,2,2549390,2550920,1530
910,FA1,7,2551615,2552985,1370
911,FC1,4,2553705,2554615,910
912,FA1,11,2556110,2558600,2490
913,FC1,4,2559580,2560620,1040
914,FA1,7,2561000,2563560,2560
915,FC1,4,2563590,2564200,610
916,FA1,4,2564995,2566355,1360
917,FC1,4,2567645,2568855,1210
918,FC1,4,2570390,2572240,1850
919,FA1,1,2571875,2572285,410
920,FA1,1,2573300,2573890,590
921,FA1,7,2574935,2578295,3360
922,FC1,4,2579565,2581435,1870
923,FA1,4,2584055,2584935,880
924,FC1,9,2587790,2591610,3820
925,FA1,14,2592850,2596380,3530
926,FC1,1,2599185,2599855,670
927,FA1,7,2600900,2602280,1380
928,FA1,1,2603187,2603827,640
929,FA1,9,2604738,2606958,2220
930,FA1,5,2607438,2608418,980
931,FA1,3,2608968,2609238,270
932,FA1,1,2609998,2610428,430
933,FC1,2,2610533,2611173,640
934,FA1,5,2611453,2612673,1220
935,FA1,4,2616298,2617558,1260
936,FC1,1,2616708,2617578,870
937,FA1,6,2618403,2620263,1860
938,FC1,6,2620273,2621603,1330
939,FA1,6,2621588,2623458,1870
940,FC1,11,2623863,2626843,2980
941,FA1,1,2626913,2627323,410
942,FC1,3,2627358,2629418,2060
943,FA1,1,2629698,2630308,610
944,FA1,5,2634043,2635743,1700
945,FC1,4,2637423,2639943,2520
946,FC1,3,2640033,2644533,4500
947,CHI,0,2643333,2644383,1050
948,FA1,5,2644408,2645968,1560
949,FC1,6,2646533,2647713,1180
950,FA1,2,2647713,2649323,1610
951,FA1,4,2649743,2651543,1800
952,CHI,0,2650568,2651568,1000
953,FA1,15,2652238,2655708,3470
954,FC1,2,2657463,2660323,2860
955,FC1,1,2660363,2660693,330
956,FA1,1,2660798,2661618,820
957,FC1,2,2661988,2662808,820
958,FA1,3,2663728,2665138,1410
959,FC1,4,2665383,2666383,1000
960,FA1,1,2667443,2667993,550
961,FA1,2,2668873,2669383,510
962,FA1,6,2671468,2672578,1110
963,FC1,5,2672983,2674573,1590
964,FA1,2,2675398,2676428,1030
965,FA1,12,2677123,2680523,3400
966,FC1,7,2681088,2682658,1570
967,FA1,8,2683083,2685213,2130
968,FC1,4,2687428,2689908,2480
969,FA1,5,2690843,2692213,1370
970,FC1,15,2692478,2699988,7510
971,FA1,12,2700593,2704253,3660
972,FC1,2,2705173,2705763,590
973,CHI,0,2705603,2706803,1200
974,FA1,8,2706823,2709243,2420
975,FA1,3,2709768,2710638,870
976,CHI,0,2716943,2717683,740
977,CHI,0,2721803,2724533,2730
978,CHI,0,2725078,2725768,690
979,FA1,1,2726873,2727533,660
980,CHI,0,2730863,2731573,710
981,FA1,1,2732228,2732808,580
982,CHI,0,2732848,2733538,690
983,CHI,0,2733893,2734693,800
984,CHI,0,2735643,2736783,1140
985,CHI,0,2737353,2738423,1070
986,CHI,0,2739978,2740638,660
987,CHI,0,2743348,2743628,280
988,CHI,0,2744548,2745528,980
989,FC1,9,2753858,2756968,3110
990,FA1,8,2756953,2758533,1580
991,CHI,0,2758183,2758863,680
992,FA1,12,2759488,2762498,3010
993,CHI,0,2759493,2760963,1470
994,FA1,4,2762543,2764433,1890
995,CHI,0,2762788,2764098,1310
996,FC1,6,2764794,2766201,1407
997,CHI,0,2765991,2768444,2453
998,FA1,2,2766653,2767153,500
999,FA1,8,2769019,2771286,2267
1000,CHI,0,2769188,2770858,1670
1001,FC1,4,2770853,2772133,1280
1002,CHI,0,2772113,2773303,1190
1003,FA1,17,2773508,2776018,2510
1004,FC1,3,2777353,2778653,1300
1005,FC1,4,2783173,2785193,2020
1006,FC1,5,2785923,2787983,2060
1007,FA1,5,2787893,2788323,430
1008,CHI,0,2788283,2789753,1470
1009,FA1,1,2789948,2790178,230
1010,CHI,0,2790818,2791992,1174
1011,CHI,0,2794603,2796133,1530
1012,FA1,7,2797148,2798818,1670
1013,CHI,0,2798890,2800220,1330
1014,FA1,1,2800325,2800755,430
1015,CHI,0,2803173,2804513,1340
1016,FA1,12,2804523,2806273,1750
1017,CHI,0,2806328,2807308,980
1018,FA1,2,2807978,2808578,600
1019,CHI,0,2810708,2812018,1310
1020,CHI,0,2812953,2813503,550
1021,FA1,7,2816743,2818223,1480
1022,FA1,4,2823123,2824783,1660
1023,FA1,4,2826033,2827513,1480
1024,FA1,5,2828003,2829073,1070
1025,FC1,5,2829778,2830748,970
1026,FA1,10,2830923,2833413,2490
1027,FC1,6,2834913,2836843,1930
1028,FA1,5,2837073,2838253,1180
1029,FC1,6,2838643,2840563,1920
1030,FA1,6,2841023,2842353,1330
1031,FC1,0,2843498,2845648,2150
1032,CHI,0,2850863,2851343,480
1033,FC1,7,2857989,2860931,2942
1034,FC1,4,2866838,2868078,1240
1035,FA1,1,2868888,2869348,460
1036,FC1,5,2869348,2870708,1360
1037,FC1,4,2872928,2874358,1430
1038,FA1,6,2874523,2875683,1160
1039,FC1,4,2877393,2878653,1260
1040,FA1,6,2878983,2880593,1610
1041,FC1,8,2881678,2884048,2370
1042,FA1,7,2884233,2886333,2100
1043,FC1,5,2889860,2890850,990
1044,FA1,4,2891113,2891953,840
1045,FC1,1,2892875,2893575,700
1046,FA1,10,2897005,2899715,2710
1047,FA1,1,2910141,2910511,370
1048,FC1,2,2912736,2913566,830
1049,FA1,2,2913686,2914886,1200
1050,FC1,2,2915381,2916891,1510
1051,FA1,3,2917076,2918536,1460
1052,FA1,13,2919011,2922081,3070
1053,FC1,4,2922066,2923836,1770
1054,CHI,0,2927281,2927801,520
1055,CHI,0,2929211,2929971,760
1056,CHI,0,2931551,2931951,400
1057,CHI,0,2933091,2933881,790
1058,CHI,0,2935676,2936326,650
1059,FA1,3,2936381,2937371,990
1060,FA1,0,2937886,2939096,1210
1061,CHI,0,2939366,2940066,700
1062,FC1,9,2941011,2943221,2210
1063,CHI,0,2943796,2944446,650
1064,FC1,5,2944788,2949532,4744
1065,CHI,0,2944811,2945541,730
1066,CHI,0,2946396,2946866,470
1067,CHI,1,2947701,2948231,530
1068,FC1,11,2949991,2953621,3630
1069,FA1,6,2955166,2957156,1990
1070,FC1,14,2958151,2963531,5380
1071,FA1,4,2961201,2962691,1490
1072,FC1,8,2966746,2969596,2850
1073,CHI,0,2974086,2974486,400
1074,CHI,0,2974716,2975426,710
1075,FA1,5,2975961,2977061,1100
1076,FA1,16,2977381,2979961,2580
1077,FC1,5,2980031,2981111,1080
1078,FA1,1,2981271,2981731,460
1079,FA1,39,2982321,2989041,6720
1080,FC1,9,2989161,2992241,3080
1081,FA1,13,2992261,2994181,1920
1082,FC1,1,2994351,2994601,250
1083,FA1,10,2994361,2996281,1920
1084,FC1,5,2996591,2998221,1630
1085,FA1,6,2999096,2999986,890
1086,FA1,15,3001421,3003361,1940
1087,FA1,3,3004876,3005276,400
1088,FA1,3,3006001,3006791,790
1089,FC1,1,3007176,3008036,860
1090,FA1,4,3008036,3009116,1080
1091,FA1,1,3009271,3009621,350
1092,FC1,2,3010296,3011076,780
1093,FA1,1,3011136,3012246,1110
1094,CHI,0,3011991,3012841,850
1095,FA1,11,3013066,3014326,1260
1096,CHI,0,3014006,3014966,960
1097,FA1,6,3014546,3015426,880
1098,CHI,0,3015446,3016116,670
1099,FA1,5,3016811,3017931,1120
1100,FC1,5,3017951,3019961,2010
1101,CHI,0,3019916,3020466,550
1102,CHI,0,3023141,3023511,370
1103,FC1,4,3023976,3025196,1220
1104,FC1,6,3029606,3032686,3080
1105,CHI,0,3031426,3031986,560
1106,FC1,8,3033086,3035566,2480
1107,FA1,11,3036936,3039036,2100
1108,FC1,9,3039686,3044776,5090
1109,FA1,1,3040001,3040471,470
1110,FA1,3,3040831,3041651,820
1111,CHI,0,3042121,3042821,700
1112,FA1,1,3042921,3043521,600
1113,CHI,0,3044301,3044801,500
1114,FC1,1,3044821,3045431,610
1115,FA1,11,3045486,3048036,2550
1116,FC1,2,3048881,3049631,750
1117,FC1,5,3051631,3053981,2350
1118,FA1,9,3051936,3053936,2000
1119,FA1,5,3054256,3055226,970
1120,FC1,8,3058351,3061761,3410
1121,FC1,0,3061961,3064061,2100
1122,CHI,0,3064081,3064801,720
1123,FC1,7,3067761,3069901,2140
1124,FC1,12,3070161,3074471,4310
1125,FC1,8,3074566,3077096,2530
1126,FA1,3,3076091,3077242,1151
1127,FC1,13,3077561,3082991,5430
1128,CHI,0,3080841,3081491,650
1129,CHI,0,3084206,3085856,1650
1130,FC1,16,3086631,3095211,8580
1131,FA1,10,3087676,3089536,1860
1132,CHI,0,3089836,3090626,790
1133,CHI,0,3091441,3092451,1010
1134,FA1,6,3095226,3097216,1990
1135,CHI,0,3099641,3100061,420
1136,FC1,4,3103581,3107071,3490
1137,FA1,1,3106426,3107006,580
1138,CHI,0,3108846,3109486,640
1139,FA1,5,3115066,3116466,1400
1140,FC1,12,3123711,3129461,5750
1141,CHI,0,3129466,3130036,570
1142,FA1,5,3130021,3131131,1110
1143,CHI,0,3133196,3133716,520
1144,CHI,0,3135276,3135886,610
1145,CHI,0,3136081,3136411,330
1146,FA1,1,3136506,3137076,570
1147,CHI,0,3137371,3137691,320
1148,FC1,7,3137740,3142390,4650
1149,FA1,1,3137751,3138181,430
1150,FA1,1,3139061,3139441,380
1151,CHI,0,3139696,3139936,240
1152,CHI,0,3139981,3140901,920
1153,FA1,2,3142210,3143560,1350
1154,CHI,0,3143950,3145550,1600
1155,CHI,0,3145850,3146820,970
1156,FA1,2,3146815,3147635,820
1157,FA1,4,3147815,3149435,1620
1158,FC1,9,3150131,3160751,10620
1159,CHI,0,3150805,3152605,1800
1160,FA1,4,3152655,3154615,1960
1161,CHI,0,3152685,3154925,2240
1162,CHI,0,3155005,3155945,940
1163,CHI,0,3158475,3159285,810
1164,FA1,7,3161105,3163055,1950
1165,CHI,0,3163490,3163780,290
1166,CHI,0,3164015,3166395,2380
1167,FC1,7,3169305,3173135,3830
1168,FA1,3,3173420,3174900,1480
1169,FA1,2,3175050,3176160,1110
1170,FC1,6,3180715,3183595,2880
1171,FA1,29,3187565,3193175,5610
1172,FC1,7,3193530,3196770,3240
1173,FA1,9,3196690,3198120,1430
1174,FC1,1,3198255,3198515,260
1175,FA1,1,3198590,3198800,210
1176,FC1,9,3199435,3202045,2610
1177,CHI,0,3206950,3207170,220
1178,FC1,4,3207675,3209675,2000
1179,FC1,2,3211895,3212395,500
1180,FC1,5,3212945,3215635,2690
1181,FC1,5,3218670,3219960,1290
1182,FA1,5,3220415,3221315,900
1183,FA1,5,3224475,3225435,960
1184,FC1,4,3229805,3232505,2700
1185,FAE,1,3233555,3233945,390
1186,FA1,1,3234220,3234880,660
1187,FA1,3,3235830,3236560,730
1188,FC1,2,3237385,3238435,1050
1189,FA1,2,3238430,3239210,780
1190,FAE,1,3239360,3240580,1220
1191,FA1,3,3240880,3241940,1060
1192,FAE,1,3242000,3245190,3190
1193,FC1,6,3242010,3244530,2520
1194,FAE,3,3245495,3246545,1050
1195,FA1,2,3246660,3247300,640
1196,FC1,4,3247400,3249490,2090
1197,FA1,7,3249330,3251560,2230
1198,FAE,2,3250885,3251575,690
1199,CHI,0,3251730,3252320,590
1200,FAE,11,3252345,3254865,2520
1201,FA1,1,3255145,3255875,730
1202,FAE,1,3256450,3256780,330
1203,FA1,1,3256775,3257155,380
1204,FC1,7,3259245,3262125,2880
1205,FA1,5,3262955,3264135,1180
1206,FC1,1,3264255,3264725,470
1207,FC1,1,3265915,3266985,1070
1208,FA1,1,3267370,3268090,720
1209,FA1,9,3269010,3271540,2530
1210,FC1,3,3271925,3272375,450
1211,FA1,2,3272725,3273055,330
1212,FC1,1,3277060,3277370,310
1213,FC1,4,3277805,3278935,1130
1214,FC1,6,3279120,3280990,1870
1215,FC1,5,3281575,3283135,1560
1216,FA1,1,3283565,3283815,250
1217,FC1,0,3289230,3290930,1700
1218,FA1,1,3291530,3292150,620
1219,FC1,4,3295180,3295730,550
1220,FA1,5,3295725,3297645,1920
1221,FC1,7,3301085,3304365,3280
1222,FA1,1,3304395,3305605,1210
1223,CHI,0,3310160,3310860,700
1224,CHI,0,3311470,3312220,750
1225,FC1,11,3312320,3318110,5790
1226,CHI,0,3314200,3314710,510
1227,FA1,1,3318265,3318715,450
1228,FC1,9,3324218,3328278,4060
1229,CHI,0,3327648,3328248,600
1230,FC1,5,3329278,3330198,920
1231,FA1,9,3330208,3332768,2560
1232,FC1,2,3333238,3333858,620
1233,FA1,2,3333858,3334708,850
1234,FA1,7,3346383,3348543,2160
1235,CHI,0,3351623,3352143,520
1236,FA1,5,3352323,3353633,1310
1237,FC1,2,3353698,3357148,3450
1238,CHI,0,3355313,3356568,1255
1239,FC1,1,3358353,3358923,570
1240,FA1,7,3358978,3360948,1970
1241,FC1,3,3361143,3362323,1180
1242,FA1,8,3362403,3365343,2940
1243,FC1,1,3365583,3366013,430
1244,FA1,3,3366388,3367098,710
1245,FC1,5,3373953,3376063,2110
1246,FA1,4,3376078,3377208,1130
1247,FC1,21,3377323,3385523,8200
1248,FA1,6,3386023,3387213,1190
1249,FC1,8,3387738,3390828,3090
1250,FA1,2,3390893,3391463,570
1251,FA1,26,3391718,3396668,4950
1252,CHI,0,3395883,3396443,560
1253,FA1,14,3397343,3399903,2560
1254,FC1,7,3403843,3405873,2030
1255,FA1,1,3406518,3407308,790
1256,FC1,1,3413393,3413953,560
1257,FC1,5,3414713,3417693,2980
1258,FC1,5,3419383,3422423,3040
1259,FA1,1,3422993,3423663,670
1260,CHI,0,3425953,3426313,360
1261,CHI,0,3432093,3432423,330
1262,FC1,8,3432818,3435948,3130
1263,FA1,1,3436153,3437383,1230
1264,CHI,0,3437558,3438188,630
1265,FC1,4,3441393,3443243,1850
1266,FA1,8,3443938,3445498,1560
1267,FC1,6,3448758,3452008,3250
1268,FA1,9,3453233,3455283,2050
1269,FC1,5,3456778,3458068,1290
1270,FA1,13,3458083,3460733,2650
1271,FC1,0,3461548,3464038,2490
1272,FA1,10,3461550,3467250,5700
1273,FC1,1,3465608,3467108,1500
1274,FC1,2,3467273,3468133,860
1275,FC1,4,3468263,3469983,1720
1276,FA1,2,3470413,3470863,450
1277,FC1,3,3471398,3472288,890
1278,FA1,4,3472403,3473293,890
1279,FC1,3,3473458,3475298,1840
1280,FC1,4,3475603,3476873,1270
1281,FA1,2,3476858,3478078,1220
1282,FC1,7,3478648,3481668,3020
1283,FA1,5,3481738,3482858,1120
1284,FC1,2,3483328,3484098,770
1285,FA1,18,3484093,3488643,4550
1286,FC1,1,3488648,3489628,980
1287,FC1,4,3492828,3494568,1740
1288,FA1,9,3495708,3497458,1750
1289,FC1,4,3497843,3500523,2680
1290,CHI,0,3502843,3503463,620
1291,FC1,7,3506543,3510533,3990
1292,CHI,0,3509179,3510667,1488
1293,FC1,12,3513898,3518208,4310
1294,FC1,7,3521003,3524573,3570
1295,CHI,0,3522488,3523248,760
1296,CHI,0,3530568,3531608,1040
1297,CHI,0,3535648,3536108,460
1298,FC1,6,3536078,3538178,2100
1299,FC1,5,3542843,3545423,2580
1300,FC1,2,3547188,3548248,1060
1301,FC1,4,3548798,3550038,1240
1302,FA1,9,3550078,3552588,2510
1303,FC1,4,3552593,3554173,1580
1304,FC1,4,3555843,3557633,1790
1305,CHI,0,3557638,3558028,390
1306,CHI,0,3558943,3559513,570
1307,FC1,9,3559958,3564058,4100
1308,FA1,6,3565293,3566783,1490
1309,FA1,6,3567828,3570588,2760
1310,CHI,0,3569968,3570248,280
1311,FA1,4,3571198,3572258,1060
1312,FC1,4,3573298,3574418,1120
1313,FC1,3,3574718,3575748,1030
1314,FC1,22,3576803,3590853,14050
1315,FA1,2,3591608,3592378,770
1316,FC1,2,3593088,3593768,680
1317,FC1,3,3594078,3596308,2230
1318,FC1,8,3600073,3604573,4500
1319,FA1,4,3605123,3606513,1390
1320,FA1,1,3606668,3607718,1050
1321,CHI,0,3607793,3608123,330
1322,FC1,4,3612628,3614278,1650
1323,CHI,0,3616310,3616410,100
1324,FC1,5,3618643,3620653,2010
1325,CHI,0,3618950,3619380,430
1326,CHI,0,3620285,3620685,400
1327,FA1,4,3622050,3623180,1130
1328,FC1,9,3623798,3628478,4680
1329,CHI,0,3625458,3625978,520
1330,CHI,0,3629288,3629548,260
1331,CHI,0,3630278,3630638,360
1332,CHI,0,3634428,3634778,350
1333,FC1,2,3635703,3636453,750
1334,FA1,2,3636468,3637258,790
1335,FA1,7,3637283,3639543,2260
1336,FC1,1,3637783,3638043,260
1337,FC1,4,3640733,3641913,1180
1338,FA1,12,3642603,3645613,3010
1339,FC1,1,3645748,3646458,710
1340,FA1,4,3646493,3647233,740
1341,CHI,0,3650133,3650723,590
1342,CHI,0,3663448,3663768,320
1343,FA1,6,3665828,3667828,2000
1344,FA1,17,3668558,3672598,4040
1345,CHI,0,3678818,3679038,220
1346,CHI,0,3681988,3682228,240
1347,FA1,1,3683648,3683868,220
1348,FA1,3,3686178,3687198,1020
1349,FA1,11,3696992,3700972,3980
1350,CHI,0,3701272,3701532,260
1351,FC1,2,3703882,3704422,540
1352,FC1,1,3704842,3705632,790
1353,FA1,2,3705937,3706547,610
1354,FC1,10,3706652,3709832,3180
1355,FA1,5,3710442,3711562,1120
1356,FC1,2,3711352,3712402,1050
1357,FA1,6,3712797,3714117,1320
1358,FC1,11,3714537,3716997,2460
1359,FA1,4,3717312,3718802,1490
1360,FC1,1,3718827,3719337,510
1361,FA1,7,3722102,3723512,1410
1362,FA1,12,3724537,3728607,4070
1363,FA1,9,3728742,3731422,2680
1364,FA1,8,3731492,3735612,4120
1365,CHI,0,3734062,3734382,320
1366,FA1,3,3746202,3747042,840
1367,FC1,5,3748682,3751082,2400
1368,FA1,1,3751267,3752157,890
1369,CHI,0,3754052,3755552,1500
1370,FC1,4,3755812,3757022,1210
1371,CHI,0,3756517,3757047,530
1372,FA1,4,3757112,3758952,1840
1373,FC1,1,3760152,3760822,670
1374,FA1,1,3761267,3762437,1170
1375,FC1,5,3768477,3769757,1280
1376,FA1,3,3770407,3772677,2270
1377,CHI,0,3772765,3776997,4232
1378,FC1,2,3773457,3774927,1470
1379,CHI,0,3777522,3778062,540
1380,CHI,0,3786282,3786902,620
1381,CHI,0,3787572,3788212,640
1382,CHI,0,3788922,3789672,750
1383,CHI,0,3790927,3791907,980
1384,CHI,0,3794107,3794637,530
1385,FA1,11,3795297,3798907,3610
1386,FC1,3,3798912,3800232,1320
1387,CHI,0,3800492,3801462,970
1388,FA1,8,3802247,3803497,1250
1389,FC1,4,3804672,3806002,1330
1390,FA1,10,3808667,3811527,2860
1391,FC1,6,3813037,3814227,1190
1392,FA1,2,3814442,3815082,640
1393,FA1,7,3816662,3818112,1450
1394,FC1,1,3817707,3818117,410
1395,FA1,2,3818512,3819332,820
1396,FC1,7,3819342,3820952,1610
1397,FA1,16,3821127,3824627,3500
1398,FC1,4,3825827,3826437,610
1399,FA1,6,3827092,3828122,1030
1400,FA1,6,3828527,3829897,1370
1401,FA1,3,3837102,3838832,1730
1402,FC1,3,3838817,3841047,2230
1403,CHI,0,3843032,3843512,480
1404,CHI,0,3846222,3846712,490
1405,FA1,7,3859757,3862477,2720
1406,FA1,3,3869155,3870702,1547
1407,CHI,0,3881057,3881627,570
1408,CHI,0,3886652,3887202,550
1409,CHI,0,3888587,3889497,910
1410,FC1,8,3898091,3902671,4580
1411,FA1,24,3902701,3908771,6070
1412,FC1,0,3909016,3909496,480
1413,FC1,6,3909996,3912916,2920
1414,FA1,8,3912976,3914886,1910
1415,FA1,15,3915336,3918806,3470
1416,FA1,7,3919771,3922751,2980
1417,FC1,7,3925051,3926571,1520
1418,FA1,16,3927911,3931101,3190
1419,FC1,8,3931811,3934281,2470
1420,CHI,0,3936336,3936696,360
1421,FA1,12,3937526,3940376,2850
1422,CHI,0,3941501,3941991,490
1423,FA1,11,3941966,3943516,1550
1424,CHI,1,3945051,3945721,670
1425,FA1,1,3945695,3946300,605
1426,CHI,1,3948316,3948886,570
1427,FA1,8,3948736,3950296,1560
1428,FC1,4,3951856,3952896,1040
1429,FA1,6,3952956,3954186,1230
1430,FC1,1,3954541,3955061,520
1431,CHI,0,3957461,3958631,1170
1432,FA1,1,3958796,3959246,450
1433,FA1,7,3965201,3967201,2000
1434,FA1,1,3968251,3968751,500
1435,FA1,10,3969361,3971861,2500
1436,FC1,2,3971881,3972571,690
1437,FA1,2,3972596,3973326,730
1438,FC1,1,3977601,3978271,670
1439,FA1,1,3978286,3978666,380
1440,FA1,7,3980816,3981986,1170
1441,CHI,0,3982001,3983201,1200
1442,FC1,3,3983841,3985191,1350
1443,FA1,3,3985266,3986206,940
1444,CHI,0,3985916,3986936,1020
1445,FC1,12,3986186,3992226,6040
1446,FA1,1,3992726,3993156,430
1447,FA1,19,3993281,3997651,4370
1448,CHI,0,3998616,3999496,880
1449,FA1,8,4000246,4002936,2690
1450,CHI,0,4002911,4003541,630
1451,CHI,0,4004776,4006646,1870
1452,FC1,3,4005121,4006951,1830
1453,FA1,2,4006986,4007786,800
1454,FA1,10,4007801,4010351,2550
1455,CHI,0,4008646,4009216,570
1456,CHI,0,4010316,4011616,1300
1457,CHI,0,4013596,4014166,570
1458,FA1,7,4014401,4017071,2670
1459,FA1,12,4017086,4019686,2600
1460,FC1,1,4020156,4020326,170
1461,FA1,6,4022371,4023461,1090
1462,CHI,0,4029256,4029676,420
1463,CHI,0,4034076,4034486,410
1464,FA1,2,4041371,4042321,950
1465,FA1,3,4042456,4043846,1390
1466,CHI,0,4046736,4046956,220
1467,CHI,0,4047186,4047366,180
1468,CHI,0,4047476,4048406,930
1469,FA1,1,4048981,4049471,490
1470,CHI,0,4049576,4050166,590
1471,FA1,1,4050201,4050871,670
1472,CHI,0,4052211,4052681,470
1473,FC1,6,4054886,4056526,1640
1474,FA1,5,4057136,4058906,1770
1475,CHI,0,4057371,4057831,460
1476,CHI,0,4058831,4059471,640
1477,FC1,6,4059721,4061321,1600
1478,CHI,0,4060151,4060531,380
1479,FA1,8,4061771,4064171,2400
1480,CHI,0,4064611,4065081,470
1481,FA1,2,4066076,4066966,890
1482,CHI,0,4067791,4068241,450
1483,FA1,6,4069106,4071186,2080
1484,CHI,0,4071376,4073066,1690
1485,FA1,4,4073841,4075041,1200
1486,CHI,0,4075141,4075341,200
1487,CHI,0,4077021,4077631,610
1488,CHI,0,4079266,4079796,530
1489,CHI,0,4081511,4081921,410
1490,CHI,0,4082796,4083696,900
1491,FC1,7,4083696,4085676,1980
1492,FA1,2,4086856,4087506,650
1493,FC1,1,4087716,4089286,1570
1494,CHI,0,4088501,4089051,550
1495,CHI,0,4089686,4090406,720
1496,FA1,3,4090701,4091631,930
1497,CHI,0,4090761,4091561,800
1498,CHI,0,4091746,4092606,860
1499,CHI,0,4093166,4093896,730
1500,FA1,2,4093846,4094386,540
1501,FA1,4,4094526,4095216,690
1502,CHI,0,4095690,4097730,2040
1503,FC1,3,4096670,4098930,2260
1504,FA1,2,4097960,4098610,650
1505,FA1,6,4098945,4100315,1370
1506,FA1,4,4100750,4102240,1490
1507,CHI,0,4103485,4104195,710
1508,FC1,4,4104365,4105755,1390
1509,FA1,14,4105290,4108380,3090
1510,CHI,0,4107320,4108890,1570
1511,CHI,0,4109950,4110910,960
1512,FC1,8,4111005,4115475,4470
1513,CHI,0,4115440,4116270,830
1514,FC1,7,4116275,4119135,2860
1515,FA1,17,4119105,4124305,5200
1516,CHI,0,4121315,4122555,1240
1517,FA1,2,4124475,4125295,820
1518,FA1,11,4126065,4128575,2510
1519,FC1,8,4129310,4130810,1500
1520,FA1,5,4131090,4132900,1810
1521,FA1,6,4133485,4135035,1550
1522,FA1,3,4135700,4136470,770
1523,FA1,6,4136495,4137615,1120
1524,FA1,5,4138585,4139815,1230
1525,FA1,1,4140650,4141100,450
1526,FA1,14,4141655,4145545,3890
1527,FC1,6,4146240,4148690,2450
1528,FA1,12,4148675,4151405,2730
1529,FA1,1,4151880,4152420,540
1530,FA1,12,4153040,4156730,3690
1531,CHI,0,4156215,4156425,210
1532,FC1,9,4157290,4161540,4250
1533,FA1,15,4161475,4164935,3460
1534,FA1,16,4166185,4169635,3450
1535,FA1,9,4170980,4173810,2830
1536,FA1,4,4177135,4178265,1130
1537,FC1,7,4178125,4180375,2250
1538,CHI,0,4178260,4184680,6420
1539,FA1,6,4181470,4182590,1120
1540,FC1,7,4183450,4185280,1830
1541,CHI,0,4184775,4188765,3990
1542,FA1,11,4185135,4187855,2720
1543,FC1,3,4189250,4190650,1400
1544,FA1,1,4189350,4189910,560
1545,FA1,6,4190630,4194450,3820
1546,FA1,5,4194540,4195810,1270
1547,CHI,0,4196165,4196995,830
1548,FA1,5,4197340,4198390,1050
1549,CHI,0,4198535,4199135,600
1550,FA1,10,4199135,4201325,2190
1551,CHI,0,4201260,4201550,290
1552,FA1,8,4202785,4204645,1860
1553,CHI,0,4204855,4205125,270
1554,CHI,0,4205200,4206160,960
1555,FC1,3,4207830,4209990,2160
1556,FA1,1,4210005,4210365,360
1557,FA1,4,4212625,4213805,1180
1558,CHI,0,4213080,4214440,1360
1559,FA1,7,4214705,4216295,1590
1560,FC1,9,4216150,4218180,2030
1561,FA1,7,4218205,4219685,1480
1562,CHI,0,4222625,4223355,730
1563,FA1,12,4223350,4225330,1980
1564,FA1,2,4225850,4226450,600
1565,CHI,0,4226920,4227450,530
1566,FA1,3,4227995,4229605,1610
1567,FA1,5,4230410,4232010,1600
1568,FA1,6,4232400,4234640,2240
1569,FA1,7,4235030,4236800,1770
1570,EE1,1,4236990,4237550,560
1571,FA1,6,4237525,4239585,2060
1572,FA1,6,4239800,4241540,1740
1573,EE1,1,4241520,4241960,440
1574,FA1,6,4241970,4243750,1780
1575,FA1,12,4245160,4247510,2350
1576,CHI,0,4250875,4251485,610
1577,EE1,3,4251470,4252630,1160
1578,FA1,5,4251520,4252690,1170
1579,FA1,1,4252755,4253865,1110
1580,EE1,1,4253490,4253950,460
1581,FA1,3,4254850,4257010,2160
1582,FA1,7,4257010,4258540,1530
1583,FA1,15,4259115,4263655,4540
1584,EE1,1,4261900,4262490,590
1585,FA1,15,4263915,4267765,3850
1586,EE1,1,4266755,4267345,590
1587,FA1,16,4267775,4270925,3150
1588,EE1,1,4270740,4271380,640
1589,FC1,2,4271550,4272240,690
1590,FA1,8,4272435,4275425,2990
1591,EE1,1,4276910,4277280,370
1592,FA1,3,4278220,4279110,890
1593,EE1,1,4279555,4280215,660
1594,EE1,1,4280605,4280935,330
1595,FC1,3,4281155,4284785,3630
1596,EE1,1,4283670,4284190,520
1597,FA1,2,4285090,4286560,1470
1598,EE1,1,4287100,4287600,500
1599,FC1,6,4288755,4292295,3540
1600,EE1,1,4290840,4291510,670
1601,EE1,1,4291985,4292765,780
1602,EE1,1,4294295,4294985,690
1603,FA1,9,4295745,4299015,3270
1604,EE1,1,4295980,4296530,550
1605,EE1,1,4297035,4297595,560
1606,EE1,1,4299895,4300525,630
1607,EE1,1,4301250,4301850,600
1608,FA1,2,4302050,4302720,670
1609,FA1,17,4303915,4307625,3710
1610,CHI,0,4305790,4306020,230
1611,CHI,0,4307155,4307605,450
1612,CHI,0,4309100,4309280,180
1613,FC1,2,4309360,4310520,1160
1614,EE1,1,4309400,4309970,570
1615,CHI,0,4312280,4312830,550
1616,FA1,5,4312935,4314905,1970
1617,FA1,2,4315410,4316630,1220
1618,FA1,3,4316780,4318010,1230
1619,CHI,0,4318095,4318885,790
1620,CHI,0,4320220,4321040,820
1621,FA1,7,4321040,4323310,2270
1622,CHI,0,4322185,4327705,5520
1623,FA1,14,4323795,4327535,3740
1624,FA1,10,4329695,4333205,3510
1625,FA1,4,4333350,4334630,1280
1626,CHI,1,4334860,4335300,440
1627,FA1,9,4335620,4337450,1830
1628,FA1,8,4338435,4339915,1480
1629,CHI,0,4340075,4340685,610
1630,FA1,7,4340645,4342245,1600
1631,FA1,4,4342975,4343665,690
1632,FA1,4,4345360,4346800,1440
1633,CHI,0,4347070,4348670,1600
1634,FA1,8,4348710,4350660,1950
1635,CHI,0,4351005,4351445,440
1636,CHI,0,4352265,4353415,1150
1637,FA1,0,4352357,4353377,1020
1638,CHI,0,4353420,4354890,1470
1639,FA1,15,4355225,4358235,3010
1640,FC1,4,4361790,4362890,1100
1641,FA1,1,4362930,4363400,470
1642,FA1,12,4364455,4366345,1890
1643,FA1,8,4368800,4370980,2180
1644,FC1,18,4371440,4377300,5860
1645,FA1,2,4377270,4378650,1380
1646,CHI,0,4382080,4383350,1270
1647,FA1,3,4382535,4383405,870
1648,CHI,0,4383350,4385800,2450
1649,FA1,11,4385650,4389760,4110
1650,CHI,0,4389855,4392785,2930
1651,FC1,6,4390635,4392765,2130
1652,FA1,7,4392780,4394530,1750
1653,FA1,6,4394750,4396080,1330
1654,CHI,0,4395225,4395945,720
1655,FA1,19,4396155,4399055,2900
1656,CHI,0,4396795,4397425,630
1657,CHI,0,4398060,4398470,410
1658,CHI,0,4399105,4399495,390
1659,FA1,6,4399590,4400900,1310
1660,FC1,2,4401045,4401865,820
1661,FA1,2,4402155,4403115,960
1662,FC1,3,4403235,4404195,960
1663,FA1,12,4404135,4408205,4070
1664,FA1,9,4408880,4411580,2700
1665,FC1,7,4411650,4414450,2800
1666,FA1,7,4414470,4416150,1680
1667,FC1,14,4417530,4421400,3870
1668,FA1,7,4421365,4422685,1320
1669,FA1,11,4424155,4426895,2740
1670,FA1,11,4427355,4430475,3120
1671,FA1,6,4430585,4432705,2120
1672,FA1,17,4432785,4436065,3280
1673,FA1,22,4436525,4440885,4360
1674,FA1,5,4440915,4441825,910
1675,FC1,2,4442550,4443500,950
1676,FC1,1,4443935,4444305,370
1677,FA1,8,4444640,4446090,1450
1678,FC1,4,4446375,4447385,1010
1679,FA1,7,4447590,4449150,1560
1680,FC1,5,4449165,4450435,1270
1681,FA1,8,4450420,4451670,1250
1682,FC1,7,4452155,4454565,2410
1683,FA1,3,4454560,4455610,1050
1684,FA1,9,4455965,4457945,1980
1685,FC1,3,4458595,4459975,1380
1686,FC1,4,4461415,4463595,2180
1687,FA1,4,4462765,4463615,850
1688,FA1,4,4463835,4465055,1220
1689,FC1,3,4465115,4466825,1710
1690,FA1,3,4466820,4467780,960
1691,FA1,7,4468200,4470680,2480
1692,FA1,5,4471000,4473010,2010
1693,FA1,1,4473225,4473655,430
1694,FC1,9,4473790,4477470,3680
1695,FA1,6,4474130,4475550,1420
1696,FA1,1,4477720,4478460,740
1697,FC1,4,4478510,4480030,1520
1698,FA1,1,4480360,4480900,540
1699,FC1,2,4481430,4482620,1190
1700,FA1,1,4483525,4484245,720
1701,FC1,1,4484245,4485265,1020
1702,FA1,6,4485245,4487225,1980
1703,FA1,9,4487235,4490015,2780
1704,FC1,4,4489065,4490475,1410
1705,FA1,7,4490440,4492240,1800
1706,FC1,2,4491820,4492830,1010
1707,FA1,16,4493175,4496155,2980
1708,FC1,5,4496535,4499455,2920
1709,FA1,1,4499585,4500465,880
1710,CHI,0,4500825,4501405,580
1711,FA1,5,4501505,4502905,1400
1712,FA1,9,4503005,4505635,2630
1713,CHI,0,4506230,4506910,680
1714,FC1,4,4506880,4509210,2330
1715,FC1,3,4513965,4515235,1270
1716,FA1,8,4515360,4517670,2310
1717,FC1,6,4519185,4522175,2990
1718,FA1,3,4522740,4524130,1390
1719,FC1,1,4524200,4524660,460
1720,FA1,1,4524670,4525780,1110
1721,FC1,4,4526555,4531805,5250
1722,FA1,1,4531910,4533170,1260
1723,FA1,1,4535730,4536580,850
1724,FA1,5,4536755,4539225,2470
1725,FA1,5,4539275,4540175,900
1726,FA1,1,4541470,4542350,880
1727,FA1,1,4542660,4544580,1920
1728,FA1,2,4545880,4547260,1380
1729,FA1,7,4547310,4548780,1470
1730,FA1,4,4548825,4550815,1990
1731,CHI,0,4550370,4550790,420
1732,FA1,1,4551080,4551780,700
1733,FA1,4,4552780,4554570,1790
1734,CHI,0,4553865,4554295,430
1735,FA1,1,4555515,4556285,770
1736,CHI,0,4556690,4557440,750
1737,FA1,1,4558285,4559065,780
1738,CHI,0,4559325,4559975,650
1739,FA1,1,4560420,4561020,600
1740,CHI,0,4561380,4562010,630
1741,FA1,1,4562665,4563325,660
1742,CHI,0,4563515,4564325,810
1743,FA1,1,4564900,4565450,550
1744,CHI,0,4566115,4567165,1050
1745,CHI,0,4567510,4568070,560
1746,FA1,1,4568200,4568690,490
1747,CHI,0,4569070,4569950,880
1748,FA1,1,4569950,4570510,560
1749,CHI,0,4572000,4572350,350
1750,FA1,1,4572735,4573245,510
1751,CHI,1,4573810,4574560,750
1752,FA1,1,4574845,4575315,470
1753,CHI,0,4575780,4576520,740
1754,FA1,8,4577150,4579260,2110
1755,CHI,0,4579265,4580145,880
1756,FA1,7,4580225,4581845,1620
1757,CHI,0,4581975,4582515,540
1758,FA1,2,4582225,4583685,1460
1759,FA1,11,4583685,4586160,2475
1760,FA1,2,4586160,4586900,740
1761,FA1,6,4589120,4590460,1340
1762,CHI,0,4590595,4591005,410
1763,FA1,5,4591500,4592440,940
1764,CHI,0,4592450,4593530,1080
1765,FA1,1,4593520,4594350,830
1766,FA1,1,4594885,4595935,1050
1767,FC1,3,4595810,4597290,1480
1768,FA1,7,4597180,4599090,1910
1769,CHI,0,4599585,4602425,2840
1770,FC1,2,4600549,4601956,1407
1771,FA1,1,4602940,4603410,470
1772,CHI,0,4604175,4604815,640
1773,FA1,1,4604905,4605385,480
1774,CHI,0,4605695,4606245,550
1775,FA1,4,4606300,4608350,2050
1776,CHI,0,4608725,4610065,1340
1777,FA1,1,4610825,4611335,510
1778,FA1,1,4613310,4613720,410
1779,FA1,1,4615375,4615985,610
1780,FA1,3,4617390,4618370,980
1781,CHI,0,4618786,4619236,450
1782,FA1,1,4619760,4620320,560
1783,FC1,2,4620670,4621730,1060
1784,FC1,4,4622120,4623180,1060
1785,FA1,3,4623200,4623940,740
1786,CHI,0,4623940,4624650,710
1787,FC1,6,4624745,4626265,1520
1788,FA1,10,4626820,4629290,2470
1789,FA1,5,4631283,4633633,2350
1790,FC1,2,4634158,4634718,560
1791,FA1,13,4635158,4638108,2950
1792,FA1,4,4638473,4639953,1480
1793,FC1,8,4640103,4640933,830
1794,FA1,12,4641388,4643408,2020
1795,FC1,1,4644328,4644758,430
1796,FA1,5,4649683,4651213,1530
1797,FC1,1,4651728,4652428,700
1798,FC1,6,4653273,4654483,1210
1799,FA1,18,4654498,4661438,6940
1800,FA1,8,4663228,4665988,2760
1801,FC1,7,4666518,4668328,1810
1802,FC1,4,4668818,4670218,1400
1803,FA1,7,4670198,4673568,3370
1804,FC1,2,4673853,4674793,940
1805,FC1,1,4688063,4689163,1100
1806,FC1,10,4689478,4691428,1950
1807,FA1,19,4691983,4696933,4950
1808,FC1,8,4697608,4700188,2580
1809,FA1,9,4701138,4703128,1990
1810,FC1,19,4703663,4706863,3200
1811,CHI,0,4707203,4709343,2140
1812,FA1,1,4709713,4710733,1020
1813,CHI,0,4711128,4712548,1420
1814,CHI,0,4712748,4714578,1830
1815,FA1,5,4714613,4715763,1150
1816,FA1,6,4716343,4718183,1840
1817,FA1,8,4718963,4720263,1300
1818,FA1,5,4720453,4721103,650
1819,FA1,4,4721658,4722638,980
1820,FA1,6,4723328,4726458,3130
1821,FC1,4,4726488,4728058,1570
1822,FA1,6,4728413,4729523,1110
1823,CHI,0,4729548,4730428,880
1824,FA1,4,4730418,4731928,1510
1825,FC1,22,4733293,4740933,7640
1826,FA1,1,4734493,4736443,1950
1827,CHI,0,4736778,4737318,540
1828,FA1,0,4737286,4738326,1040
1829,FC1,0,4742111,4745441,3330
1830,CHI,0,4742786,4743606,820
1831,FA1,12,4743916,4746976,3060
1832,FA1,6,4748736,4749556,820
1833,CHI,0,4750146,4750666,520
1834,FA1,1,4751906,4753806,1900
1835,FC1,0,4753861,4754251,390
1836,FA1,4,4754276,4755626,1350
1837,CHI,0,4756326,4757006,680
1838,CHI,0,4757996,4759716,1720
1839,FC1,9,4759706,4761696,1990
1840,FA1,6,4761271,4762331,1060
1841,FA1,4,4762511,4762921,410
1842,FC1,3,4762826,4763686,860
1843,CHI,0,4764366,4765836,1470
1844,FA1,8,4765801,4767501,1700
1845,FA1,2,4769676,4770396,720
1846,FA1,6,4770396,4773076,2680
1847,FC1,1,4773216,4774296,1080
1848,CHI,1,4774276,4776266,1990
1849,FA1,8,4776251,4778151,1900
1850,CHI,1,4779351,4779831,480
1851,FC1,3,4780531,4781211,680
1852,FA1,5,4781191,4782381,1190
1853,FC1,1,4782201,4782381,180
1854,FC1,1,4786841,4788231,1390
1855,FA1,1,4788936,4791356,2420
1856,FC1,1,4791946,4793946,2000
1857,FA1,4,4792806,4793946,1140
1858,FA1,1,4793966,4794356,390
1859,CHI,0,4794561,4795281,720
1860,FA1,3,4795291,4796451,1160
1861,FA1,3,4797111,4798041,930
1862,FA1,7,4798056,4799316,1260
1863,CHI,0,4799426,4799706,280
1864,FA1,6,4799536,4800656,1120
1865,FA1,9,4800676,4802356,1680
1866,FA1,5,4802506,4803156,650
1867,FA1,0,4804591,4804991,400
1868,CHI,0,4804961,4805581,620
1869,CHI,0,4805601,4806361,760
1870,CHI,0,4806511,4806911,400
1871,FA1,1,4807261,4809071,1810
1872,CHI,0,4808141,4809001,860
1873,CHI,0,4809786,4810536,750
1874,FA1,7,4810511,4812261,1750
1875,FA1,5,4813036,4814036,1000
1876,FC1,3,4813051,4813501,450
1877,FC1,2,4814046,4814826,780
1878,FA1,6,4814816,4816326,1510
1879,FA1,4,4818216,4819416,1200
1880,FA1,1,4819936,4821056,1120
1881,FA1,4,4821066,4822266,1200
1882,CHI,0,4822246,4823916,1670
1883,FA1,1,4824981,4825421,440
1884,CHI,0,4827501,4828021,520
1885,FA1,7,4827506,4828846,1340
1886,FA1,2,4828846,4829931,1085
1887,CHI,0,4831736,4832186,450
1888,CHI,0,4832191,4832901,710
1889,FA1,2,4833126,4833826,700
1890,FA1,4,4833826,4834846,1020
1891,FA1,1,4837706,4838126,420
1892,FA1,1,4839146,4839536,390
1893,FA1,3,4839776,4840816,1040
1894,FC1,3,4840816,4842186,1370
1895,FA1,1,4843121,4844191,1070
1896,CHI,0,4844176,4844676,500
1897,CHI,0,4845586,4846656,1070
1898,FA1,9,4848821,4851101,2280
1899,CHI,0,4850761,4851431,670
1900,FC1,2,4851366,4852966,1600
1901,FA1,8,4853356,4855396,2040
1902,FC1,1,4855466,4856306,840
1903,FA1,1,4856306,4857056,750
1904,CHI,0,4860291,4860551,260
1905,CHI,0,4861551,4863511,1960
1906,FA1,10,4861961,4865341,3380
1907,FC1,6,4865231,4866451,1220
1908,FA1,1,4866580,4868550,1970
1909,FC1,7,4867650,4869890,2240
1910,FA1,1,4870025,4871325,1300
1911,FC1,3,4870025,4870735,710
1912,FC1,3,4871405,4872965,1560
1913,FA1,3,4873100,4873530,430
1914,CHI,0,4873575,4874215,640
1915,FA1,1,4874365,4874845,480
1916,CHI,0,4875065,4875645,580
1917,FA1,7,4876315,4877605,1290
1918,FC1,3,4877830,4879180,1350
1919,FC1,2,4879565,4880655,1090
1920,FC1,0,4880690,4885140,4450
1921,FA1,14,4881515,4885155,3640
1922,CHI,0,4885775,4886545,770
1923,FC1,0,4886610,4888260,1650
1924,FC1,0,4888885,4890335,1450
1925,CHI,0,4891820,4892440,620
1926,FA1,5,4892460,4895560,3100
1927,CHI,0,4895660,4896460,800
1928,FA1,6,4896530,4897880,1350
1929,FA1,4,4898345,4900195,1850
1930,CHI,0,4899210,4899520,310
1931,FA1,1,4900595,4900985,390
1932,FA1,0,4902760,4903630,870
1933,CHI,0,4903755,4904805,1050
1934,FA1,4,4904850,4906720,1870
1935,FC1,7,4907035,4910105,3070
1936,FA1,5,4910070,4911750,1680
1937,FA1,11,4911750,4914560,2810
1938,FA1,4,4914725,4915685,960
1939,CHI,0,4916215,4918475,2260
1940,FA1,4,4923305,4923965,660
1941,FAE,7,4928265,4930395,2130
1942,FA1,11,4930430,4932930,2500
1943,FC1,5,4934710,4936780,2070
1944,FAE,3,4937415,4938685,1270
1945,FC1,0,4938745,4939795,1050
1946,FAE,1,4940775,4941375,600
1947,FC1,4,4942380,4944370,1990
1948,FAE,1,4945385,4945755,370
1949,FC1,3,4946030,4947180,1150
1950,FAE,5,4948145,4950125,1980
1951,FA1,5,4951035,4951945,910
1952,FAE,1,4952530,4953190,660
1953,FA1,11,4953210,4955090,1880
1954,CHI,0,4955290,4955820,530
1955,FA1,13,4956835,4959905,3070
1956,CHI,0,4959910,4960620,710
1957,FAE,1,4961305,4962355,1050
1958,CHI,0,4962640,4964050,1410
1959,CHI,0,4965725,4966515,790
1960,FA1,7,4967350,4968730,1380
1961,FAE,4,4969630,4970510,880
1962,CHI,0,4970510,4971480,970
1963,FA1,8,4971665,4973615,1950
1964,FA1,9,4974410,4976650,2240
1965,CHI,0,4976725,4977255,530
1966,FAE,1,4981030,4981470,440
1967,CHI,0,4982510,4983200,690
1968,FAE,7,4983455,4986445,2990
1969,FC1,8,4987065,4990465,3400
1970,FAE,1,4987430,4988180,750
1971,FA1,5,4990745,4992195,1450
1972,FC1,7,4992810,4994980,2170
1973,FAE,9,4992815,4994945,2130
1974,FC1,7,4995175,4996345,1170
1975,FA1,7,4996600,4997690,1090
1976,FA1,5,4997705,4998465,760
1977,FAE,10,4999370,5001130,1760
1978,FA1,3,5001510,5002470,960
1979,FA1,3,5002770,5003620,850
1980,FAE,3,5004685,5005765,1080
1981,FAE,5,5007715,5008835,1120
1982,FA1,10,5009555,5012575,3020
1983,FAE,2,5014135,5015485,1350
1984,FA1,11,5016740,5022110,5370
1985,FA1,4,5023205,5024555,1350
1986,FAE,12,5026050,5029570,3520
1987,FA1,17,5030200,5035020,4820
1988,FA1,23,5036860,5042010,5150
1989,FAE,1,5043125,5043755,630
1990,FAE,7,5043900,5045800,1900
1991,FC1,4,5044625,5045775,1150
1992,FA1,4,5045810,5046260,450
1993,FA1,6,5046400,5047720,1320
1994,FAE,1,5048370,5048910,540
1995,FA1,6,5048920,5050060,1140
1996,FA1,13,5050690,5053710,3020
1997,FAE,2,5055710,5056630,920
1998,FAE,3,5056780,5058240,1460
1999,FAE,5,5058300,5062000,3700
2000,FAE,6,5065220,5067140,1920
2001,CHI,0,5071925,5072915,990
2002,FA1,5,5072980,5074740,1760
2003,FAE,6,5074970,5077590,2620
2004,FA1,3,5078060,5079420,1360
2005,CHI,0,5078880,5079140,260
2006,FAE,2,5080390,5081220,830
2007,CHI,0,5080955,5081215,260
2008,FA1,7,5081410,5082640,1230
2009,CHI,0,5082785,5083095,310
2010,FAE,1,5083470,5083650,180
2011,FAE,6,5084570,5086530,1960
2012,FA1,5,5086660,5087620,960
2013,FA1,3,5088130,5088940,810
2014,FA1,7,5089085,5090485,1400
2015,CHI,0,5090655,5091255,600
2016,FA1,12,5091245,5094885,3640
2017,FAE,3,5095673,5096813,1140
2018,FC1,6,5096803,5098393,1590
2019,FAE,0,5098118,5099238,1120
2020,FA1,12,5099578,5102668,3090
2021,FC1,2,5101773,5102723,950
2022,FA1,12,5103258,5105568,2310
2023,FC1,9,5105773,5108113,2340
2024,FA1,10,5108783,5111233,2450
2025,FA1,13,5111578,5114838,3260
2026,FC1,9,5114848,5117818,2970
2027,FC1,4,5117853,5118863,1010
2028,FA1,4,5119098,5119988,890
2029,FA1,12,5122408,5127458,5050
2030,CHI,0,5123383,5123733,350
2031,CHI,0,5125498,5126318,820
2032,FAE,4,5128958,5130208,1250
2033,FA1,19,5130363,5135563,5200
2034,FA1,8,5136578,5137758,1180
2035,FA1,2,5138828,5139908,1080
2036,FA1,1,5141108,5143728,2620
2037,CHI,0,5144358,5144808,450
2038,FA1,4,5145281,5147391,2110
2039,FA1,1,5147666,5148366,700
2040,FA1,5,5148976,5149646,670
2041,FC1,1,5151151,5151901,750
2042,CHI,0,5155406,5156026,620
2043,FA1,7,5156046,5158176,2130
2044,FC1,4,5162421,5163691,1270
2045,FA1,11,5165666,5168616,2950
2046,CHI,0,5168611,5170271,1660
2047,FA1,5,5169811,5171041,1230
2048,FA1,1,5171356,5171686,330
2049,FC1,3,5172651,5174141,1490
2050,CHI,0,5174236,5175776,1540
2051,FAE,1,5175936,5176936,1000
2052,FC1,6,5177336,5179096,1760
2053,FA1,6,5179086,5180786,1700
2054,FA1,11,5180816,5182736,1920
2055,CHI,0,5182746,5183106,360
2056,CHI,0,5184121,5185411,1290
2057,CHI,0,5186686,5186946,260
2058,CHI,0,5187556,5188056,500
2059,CHI,0,5188716,5189066,350
2060,FAE,6,5189651,5191881,2230
2061,CHI,0,5190436,5191086,650
2062,FA1,6,5192426,5194556,2130
2063,FAE,2,5197366,5198226,860
2064,FC1,0,5198516,5199586,1070
2065,CHI,0,5200541,5200911,370
2066,CHI,0,5202291,5202911,620
2067,FA1,1,5203031,5203881,850
2068,FC1,6,5203441,5205071,1630
2069,CHI,0,5206386,5207656,1270
2070,FA1,8,5207681,5210131,2450
2071,FAE,4,5210266,5212616,2350
2072,CHI,0,5214971,5215501,530
2073,FA1,2,5216186,5216996,810
2074,CHI,0,5217731,5218121,390
2075,CHI,0,5218846,5219336,490
2076,FA1,12,5219321,5223051,3730
2077,CHI,0,5223136,5224756,1620
2078,FC1,8,5224226,5227266,3040
2079,FA1,8,5227366,5228996,1630
2080,CHI,0,5229161,5230081,920
2081,FC1,6,5230851,5233011,2160
2082,FAE,1,5233851,5234091,240
2083,FA1,6,5237046,5237736,690
2084,FA1,7,5238341,5239641,1300
2085,FC1,11,5239741,5242031,2290
2086,FC1,5,5242496,5244556,2060
2087,FA1,1,5244556,5245466,910
2088,FA1,13,5246471,5249631,3160
2089,CHI,0,5249791,5251421,1630
2090,CHI,0,5254445,5255125,680
2091,FA1,4,5257110,5257830,720
2092,CHI,0,5257145,5258195,1050
2093,FA1,2,5258370,5259210,840
2094,FAE,3,5260175,5260855,680
2095,FA1,7,5260890,5262420,1530
2096,CHI,0,5262865,5266315,3450
2097,FAE,2,5262865,5263925,1060
2098,FA1,7,5265885,5268665,2780
2099,CHI,0,5267555,5268665,1110
2100,CHI,0,5268860,5269710,850
2101,FA1,1,5268880,5269670,790
2102,FA1,1,5270175,5270685,510
2103,FC1,4,5275040,5276380,1340
2104,CHI,0,5276290,5279420,3130
2105,FA1,5,5276815,5278535,1720
2106,FA1,3,5281285,5282385,1100
2107,CHI,0,5282355,5284235,1880
2108,FA1,4,5283755,5284855,1100
2109,FA1,12,5284945,5286995,2050
2110,FA1,8,5287030,5288720,1690
2111,CHI,0,5288295,5289095,800
2112,FA1,7,5289065,5290075,1010
2113,FC1,8,5290225,5291635,1410
2114,CHI,0,5291690,5292400,710
2115,FA1,8,5292720,5294370,1650
2116,CHI,0,5294410,5295200,790
2117,FA1,2,5295285,5296855,1570
2118,CHI,0,5296965,5297535,570
2119,CHI,0,5297880,5299160,1280
2120,FC1,0,5297880,5299160,1280
2121,FAE,1,5299780,5300770,990
2122,FA1,9,5302445,5304645,2200
2123,FAE,4,5312415,5313345,930
2124,FA1,19,5313995,5320055,6060
2125,FAE,5,5323395,5325065,1670
2126,FA1,6,5325590,5327080,1490
2127,FA1,2,5327535,5328535,1000
2128,FA1,7,5329155,5331905,2750
2129,FA1,3,5334670,5335790,1120
2130,FAE,1,5335830,5336430,600
2131,FC1,10,5336960,5339350,2390
2132,FA1,7,5339635,5341915,2280
2133,CHI,0,5344225,5347605,3380
2134,FA1,1,5347995,5348665,670
2135,CHI,0,5349435,5350105,670
2136,FA1,10,5350340,5352280,1940
2137,FAE,0,5352330,5353110,780
2138,CHI,0,5353890,5354260,370
2139,FC1,1,5356715,5357215,500
2140,FA1,6,5358195,5360455,2260
2141,CHI,0,5361115,5361735,620
2142,CHI,0,5362015,5362335,320
2143,FC1,3,5362395,5364355,1960
2144,FA1,12,5364765,5368725,3960
2145,FAE,6,5369425,5372055,2630
2146,FA1,4,5372810,5374340,1530
2147,FA1,9,5375295,5376925,1630
2148,FC1,1,5377160,5377660,500
2149,FA1,4,5377740,5379130,1390
2150,FA1,6,5381085,5382375,1290
2151,FA1,5,5382900,5383790,890
2152,CHI,0,5384595,5386805,2210
2153,FA1,3,5386490,5388560,2070
2154,CHI,0,5388965,5389385,420
2155,FA1,5,5389075,5389865,790
2156,FAE,4,5390250,5392310,2060
2157,FA1,5,5393830,5395430,1600
2158,FA1,0,5395830,5396630,800
2159,CHI,0,5396690,5397830,1140
2160,FAE,1,5397860,5398860,1000
2161,CHI,0,5398860,5400690,1830
2162,FA1,2,5400705,5401375,670
2163,FAE,3,5401750,5403340,1590
2164,CHI,0,5402395,5402765,370
2165,FC1,1,5402730,5403330,600
2166,FA1,3,5403420,5404440,1020
2167,FA1,1,5404890,5405260,370
2168,FA1,5,5405715,5406815,1100
2169,FAE,0,5407845,5410385,2540
2170,CHI,0,5409185,5409475,290
2171,FA1,6,5410310,5411150,840
2172,FAE,4,5412730,5413210,480
2173,FA1,5,5415320,5416730,1410
2174,FAE,7,5418385,5423285,4900
2175,FA1,1,5424415,5424865,450
2176,CHI,0,5425160,5425670,510
2177,FA1,1,5425695,5426035,340
2178,FC1,1,5426915,5427405,490
2179,CHI,0,5429120,5432570,3450
2180,FC1,1,5433625,5434015,390
2181,FAE,4,5433925,5435675,1750
2182,FA1,1,5435600,5435880,280
2183,FC1,1,5435920,5436900,980
2184,FA1,3,5436130,5437310,1180
2185,FAE,4,5437990,5439350,1360
2186,FA1,4,5438680,5441250,2570
2187,CHI,0,5441285,5441925,640
2188,FC1,3,5442115,5443395,1280
2189,FA1,5,5443125,5444395,1270
2190,CHI,0,5444270,5444860,590
2191,FC1,0,5444635,5445845,1210
2192,FA1,14,5446520,5448740,2220
2193,FA1,11,5453030,5455000,1970
2194,CHI,0,5455025,5456415,1390
2195,FAE,4,5457050,5460080,3030
2196,CHI,0,5460075,5460725,650
2197,FA1,1,5460850,5461550,700
2198,CHI,0,5461590,5462160,570
2199,FA1,5,5463455,5464535,1080
2200,FAE,1,5465315,5465575,260
2201,FA1,2,5466150,5466590,440
2202,FA1,6,5468810,5470170,1360
2203,FC1,2,5470860,5471590,730
2204,CHI,0,5472695,5474215,1520
2205,FA1,8,5474455,5476615,2160
2206,FAE,1,5477625,5477995,370
2207,FA1,3,5479100,5480240,1140
2208,FAE,4,5480860,5481570,710
2209,FA1,3,5481615,5482145,530
2210,FC1,1,5482370,5482890,520
2211,CHI,0,5483080,5484710,1630
2212,FC1,5,5483670,5485440,1770
2213,FA1,6,5485915,5487905,1990
2214,FA1,5,5488355,5489645,1290
2215,FA1,4,5490030,5491860,1830
2216,FC1,1,5491305,5491635,330
2217,FC1,0,5493110,5493720,610
2218,FC1,2,5494035,5495325,1290
2219,FA1,18,5495730,5500760,5030
2220,FA1,5,5500915,5502515,1600
2221,CHI,0,5502135,5502515,380
2222,FA1,15,5503185,5506315,3130
2223,FC1,4,5511270,5513590,2320
2224,FC1,0,5514480,5515890,1410
2225,FC1,2,5516295,5518605,2310
2226,FA1,13,5518730,5521760,3030
2227,FC1,1,5522395,5522785,390
2228,FA1,6,5540950,5542070,1120
2229,CHI,0,5544230,5545380,1150
2230,FA1,1,5549275,5549705,430
2231,FA1,19,5556250,5560470,4220
2232,CHI,0,5561360,5561620,260
2233,FA1,5,5561855,5563205,1350
2234,FC1,6,5561860,5564130,2270
2235,FA1,1,5564110,5564740,630
2236,FC1,4,5572315,5573485,1170
2237,FA1,8,5574160,5575400,1240
2238,FC1,0,5576660,5577390,730
2239,FA1,6,5577485,5578325,840
2240,FA1,3,5579405,5580065,660
2241,FA1,3,5581145,5582665,1520
2242,FA1,7,5586745,5588225,1480
2243,FA1,2,5589485,5591175,1690
2244,FC1,4,5593490,5595950,2460
2245,FC1,8,5595970,5598060,2090
2246,FA1,11,5598655,5601105,2450
2247,FC1,5,5601350,5603200,1850
2248,FA1,1,5603315,5603975,660
2249,FA1,1,5654390,5657710,3320
2250,FC1,7,5658920,5660750,1830
2251,FA1,7,5660775,5662235,1460
2252,FA1,5,5665975,5667095,1120
2253,CHI,0,5686985,5688075,1090
2254,CHI,0,5688760,5690000,1240
2255,CHI,0,5693200,5695640,2440
2256,CHI,0,5698950,5699680,730
2257,CHI,0,5701015,5701775,760
2258,CHI,0,5703775,5705475,1700
2259,CHI,0,5705685,5709655,3970
2260,CHI,0,5740325,5741295,970
2261,FA1,8,5754050,5756450,2400
2262,FA1,6,5756740,5758480,1740
2263,FC1,3,5760340,5761580,1240
2264,FA1,10,5761600,5765290,3690
2265,FA1,4,5766800,5767580,780
2266,FC1,7,5767780,5770790,3010
2267,FA1,17,5771395,5775425,4030
2268,FA1,9,5776980,5778850,1870
2269,CHI,0,5849285,5849775,490
2270,CHI,0,5850820,5851070,250
2271,FA1,1,5851835,5852265,430
2272,CHI,0,5851925,5852565,640
2273,FA1,1,5852780,5853100,320
2274,CHI,0,5854480,5854830,350
2275,FA1,1,5855055,5855425,370
2276,CHI,0,5855980,5856280,300
2277,FA1,1,5856580,5856810,230
2278,CHI,0,5857165,5857365,200
2279,FA1,1,5857715,5857895,180
2280,CHI,0,5858155,5858425,270
2281,FA1,1,5858690,5858870,180
2282,CHI,0,5859080,5859260,180
2283,FA1,1,5859930,5860450,520
2284,CHI,0,5860660,5861420,760
2285,CHI,0,5862160,5862430,270
2286,CHI,0,5863305,5863935,630
2287,FC1,3,5864500,5866030,1530
2288,FC1,0,5883755,5885345,1590
2289,FC1,5,5904710,5908550,3840
2290,FC1,0,5909560,5910580,1020
2291,FA1,7,5913305,5916355,3050
2292,FA1,7,5916640,5918450,1810
2293,FA1,6,5918685,5921365,2680
2294,CHI,0,5921675,5922155,480
2295,FA1,15,5922265,5924925,2660
2296,FC1,1,5924975,5925275,300
2297,FA1,7,5925445,5927195,1750
2298,CHI,0,5943390,5943830,440
2299,CHI,0,5944470,5945000,530
2300,CHI,0,5945625,5946175,550
2301,CHI,0,5947700,5948240,540
2302,CHI,0,5949770,5949960,190
2303,CHI,0,5951275,5951635,360
2304,FA1,7,5951835,5954085,2250
2305,FA1,9,5954250,5957130,2880
2306,FA1,3,5957860,5958930,1070
2307,FA1,4,5959145,5960865,1720
2308,FC1,3,5961245,5962425,1180
2309,FA1,8,5962645,5964165,1520
2310,FC1,4,5965025,5966685,1660
2311,CHI,0,5966755,5967025,270
2312,CHI,0,5968910,5969440,530
2313,FA1,11,5969585,5971615,2030
2314,CHI,0,5970880,5971190,310
2315,FA1,5,5973315,5974345,1030
2316,FA1,3,5975280,5976330,1050
2317,FA1,6,5978375,5980045,1670
2318,FC1,4,5983890,5985130,1240
2319,FA1,6,5985130,5987250,2120
2320,FA1,1,5987300,5988360,1060
2321,FA1,3,5989020,5990500,1480
2322,FA1,4,5991110,5993090,1980
2323,FA1,1,5993200,5994190,990
2324,CHI,0,5994655,5995445,790
2325,FA1,2,5997050,5997380,330
2326,FA1,2,5999595,5999965,370
2327,FA1,2,6001665,6002125,460
2328,CHI,0,6002345,6003535,1190
2329,FC1,12,6004080,6007170,3090
2330,FA1,1,6009345,6009755,410
2331,CHI,0,6009985,6010115,130
2332,FA1,1,6010380,6010930,550
2333,CHI,0,6011070,6011270,200
2334,FA1,6,6011385,6012865,1480
2335,FA1,3,6012915,6013835,920
2336,CHI,0,6014825,6015065,240
2337,FA1,3,6015375,6016335,960
2338,CHI,0,6016535,6017055,520
2339,FA1,1,6017425,6018015,590
2340,CHI,0,6018390,6018710,320
2341,FA1,1,6018760,6019290,530
2342,CHI,0,6019640,6019830,190
2343,FA1,1,6020045,6020575,530
2344,CHI,0,6020610,6020800,190
2345,FA1,1,6021005,6021545,540
2346,CHI,0,6021565,6021675,110
2347,FA1,1,6021910,6022410,500
2348,CHI,0,6022480,6022690,210
2349,FA1,1,6022845,6023255,410
2350,CHI,0,6023350,6023500,150
2351,FA1,2,6023745,6024665,920
2352,CHI,0,6025135,6025705,570
2353,FC1,3,6025310,6026010,700
2354,CHI,0,6026250,6026500,250
2355,FA1,6,6026715,6028065,1350
2356,FA1,2,6028150,6028620,470
2357,FA1,2,6028725,6029155,430
2358,FA1,2,6029180,6029600,420
2359,CHI,0,6029645,6031325,1680
2360,FA1,2,6031035,6031355,320
2361,FC1,2,6031035,6031355,320
2362,FA1,2,6031365,6031645,280
2363,FC1,2,6031365,6031645,280
2364,FA1,2,6031735,6032275,540
2365,FC1,2,6031735,6032275,540
2366,CHI,0,6032295,6033515,1220
2367,CHI,0,6033825,6034795,970
2368,CHI,0,6035660,6036300,640
2369,FA1,2,6036680,6037220,540
2370,FC1,1,6037910,6038450,540
2371,FA1,1,6042465,6043075,610
2372,CHI,0,6045340,6046320,980
2373,FC1,7,6046300,6047660,1360
2374,FA1,2,6046320,6047380,1060
2375,FA1,17,6047900,6050450,2550
2376,FA1,6,6050575,6051505,930
2377,FC1,1,6051520,6052110,590
2378,FA1,5,6052525,6053645,1120
2379,CHI,0,6053215,6054265,1050
2380,CHI,0,6055910,6056280,370
2381,CHI,0,6056595,6056895,300
2382,CHI,0,6058885,6059155,270
2383,CHI,0,6059540,6060660,1120
2384,CHI,0,6060760,6061310,550
2385,CHI,0,6061355,6061965,610
2386,CHI,0,6062020,6062830,810
2387,CHI,0,6064805,6065345,540
2388,FA1,6,6066685,6069165,2480
2389,FA1,5,6069275,6070885,1610
2390,FA1,2,6073410,6074430,1020
2391,FA1,7,6077880,6080080,2200
2392,FC1,4,6081130,6082110,980
2393,FC1,3,6082130,6083030,900
2394,FA1,2,6083030,6083960,930
2395,FA1,1,6084795,6085265,470
2396,FA1,6,6085490,6087230,1740
2397,CHI,0,6088660,6088900,240
2398,FA1,11,6090120,6092130,2010
2399,FA1,2,6094725,6095275,550
2400,FA1,4,6097400,6098750,1350
2401,CHI,0,6099655,6099855,200
2402,CHI,0,6102595,6102835,240
2403,CHI,0,6103305,6103655,350
2404,FA1,13,6104540,6107290,2750
2405,CHI,0,6107535,6119505,11970
2406,FA1,5,6109585,6111005,1420
2407,FA1,5,6113235,6114305,1070
2408,FA1,3,6117180,6118400,1220
2409,CHI,0,6121300,6122640,1340
2410,FA1,5,6123370,6124520,1150
2411,CHI,0,6125025,6125295,270
2412,FA1,2,6125470,6126030,560
2413,FA1,5,6126280,6126950,670
2414,FA1,1,6127225,6127535,310
2415,CHI,0,6127230,6127940,710
2416,FA1,1,6127935,6128385,450
2417,CHI,0,6127950,6128810,860
2418,FA1,2,6129190,6130590,1400
2419,FA1,1,6131140,6131770,630
2420,CHI,0,6132270,6134700,2430
2421,FA1,1,6133675,6134265,590
2422,CHI,0,6134705,6136825,2120
2423,FA1,2,6135685,6136805,1120
2424,CHI,0,6136845,6137655,810
2425,CHI,0,6138070,6139520,1450
2426,FA1,0,6140665,6141895,1230
2427,FA1,7,6142600,6144060,1460
2428,CHI,0,6144710,6145280,570
2429,FA1,2,6145495,6146055,560
2430,FA1,5,6146605,6148025,1420
2431,CHI,0,6147985,6148855,870
2432,FA1,8,6148830,6150190,1360
2433,CHI,0,6150200,6151170,970
2434,CHI,0,6152145,6152535,390
2435,FC1,2,6153650,6155490,1840
2436,FC1,2,6155820,6156980,1160
2437,FA1,7,6157320,6158940,1620
2438,FA1,10,6159980,6161680,1700
2439,FA1,5,6161690,6163130,1440
2440,FA1,1,6168940,6169180,240
2441,CHI,0,6174580,6174820,240
2442,FA1,1,6183200,6183700,500
2443,FA1,0,6187150,6189510,2360
2444,CHI,0,6190570,6191560,990
2445,CHI,0,6192255,6192795,540
2446,CHI,0,6193365,6194005,640
2447,FA1,7,6205098,6206258,1160
2448,CHI,0,6206248,6206758,510
2449,FA1,4,6209563,6210563,1000
2450,FC1,7,6213793,6215223,1430
2451,CHI,0,6215223,6215503,280
2452,FA1,1,6215860,6216190,330
2453,FA1,7,6216605,6218355,1750
2454,FC1,9,6219550,6222430,2880
2455,CHI,0,6220095,6221795,1700
2456,CHI,0,6222430,6223110,680
2457,CHI,0,6223560,6224280,720
2458,CHI,0,6224530,6226980,2450
2459,FA1,0,6225520,6226910,1390
2460,CHI,0,6227325,6230645,3320
2461,FC1,6,6227595,6230615,3020
2462,CHI,0,6231535,6232325,790
2463,CHI,0,6234810,6235270,460
2464,FA1,2,6235555,6236065,510
2465,CHI,0,6236550,6237120,570
2466,FA1,2,6237350,6237910,560
2467,CHI,0,6239000,6239430,430
2468,CHI,0,6243795,6243875,80
2469,CHI,0,6246535,6247715,1180
2470,FA1,1,6248145,6248545,400
2471,FC1,4,6248605,6250395,1790
2472,FC1,3,6250970,6251970,1000
2473,FA1,8,6252220,6254010,1790
2474,FA1,8,6254075,6255395,1320
2475,FC1,5,6255725,6256955,1230
2476,CHI,0,6258550,6258850,300
2477,CHI,0,6259750,6259900,150
2478,FA1,30,6260665,6270805,10140
2479,CHI,0,6267715,6270285,2570
2480,FC1,5,6270330,6272640,2310
2481,FA1,8,6272965,6275335,2370
2482,FA1,16,6277860,6281680,3820
2483,CHI,0,6282960,6283390,430
2484,CHI,0,6284095,6284715,620
2485,CHI,0,6284965,6285775,810
2486,FC1,8,6286180,6289250,3070
2487,FA1,6,6289585,6291505,1920
2488,FC1,1,6292075,6292495,420
2489,FA1,1,6292925,6293455,530
2490,FA1,4,6293770,6295470,1700
2491,CHI,0,6295700,6296010,310
2492,FA1,1,6296285,6296565,280
2493,FC1,10,6297855,6301215,3360
2494,FA1,16,6301415,6304695,3280
2495,FC1,0,6302125,6308115,5990
2496,FC1,5,6312060,6313860,1800
2497,FA1,5,6313930,6315210,1280
2498,FC1,7,6315220,6317220,2000
2499,CHI,0,6316130,6317230,1100
2500,FA1,1,6317400,6318380,980
2501,FC1,4,6318400,6319320,920
2502,FA1,4,6320520,6321800,1280
2503,FC1,5,6321970,6324100,2130
2504,FC1,3,6324565,6325425,860
2505,FA1,9,6324720,6330470,5750
2506,CHI,0,6326125,6327255,1130
2507,CHI,0,6330685,6331645,960
2508,CHI,0,6331760,6332730,970
2509,FC1,3,6331775,6334225,2450
2510,CHI,0,6332795,6335875,3080
2511,FA1,1,6336220,6337000,780
2512,CHI,0,6337060,6338790,1730
2513,CHI,0,6338945,6339355,410
2514,CHI,0,6339970,6340910,940
2515,FA1,5,6341820,6343530,1710
2516,CHI,0,6342855,6343555,700
2517,FA1,4,6343735,6344645,910
2518,CHI,0,6344485,6345425,940
2519,FA1,4,6345895,6347145,1250
2520,FC1,0,6347180,6348410,1230
2521,FA1,1,6347855,6348335,480
2522,FA1,1,6349945,6350845,900
2523,CHI,0,6351240,6352410,1170
2524,FA1,7,6351915,6355385,3470
2525,FC1,0,6355360,6355840,480
2526,FA1,1,6356610,6358730,2120
2527,FA1,6,6359100,6362900,3800
2528,FA1,2,6363750,6364160,410
2529,CHI,0,6364325,6371905,7580
2530,FA1,5,6365205,6366905,1700
2531,FA1,12,6368855,6371875,3020
2532,FA1,11,6374315,6376455,2140
2533,CHI,0,6378215,6378745,530
2534,FA1,1,6383890,6384210,320
2535,FA1,13,6384470,6386570,2100
2536,FA1,13,6387270,6389980,2710
2537,FA1,8,6390135,6391775,1640
2538,CHI,0,6393475,6398315,4840
2539,FA1,1,6394875,6398005,3130
2540,CHI,0,6398770,6399260,490
2541,FA1,6,6400545,6402075,1530
2542,CHI,0,6403450,6404020,570
2543,FA1,5,6404195,6405285,1090
2544,CHI,0,6405600,6406120,520
2545,FA1,11,6406130,6407820,1690
2546,FA1,1,6408055,6408415,360
2547,FA1,8,6409455,6411855,2400
2548,FC1,5,6411865,6413115,1250
2549,FA1,1,6413590,6413950,360
2550,FA1,1,6414680,6414880,200
2551,FA1,5,6415150,6416250,1100
2552,FA1,7,6416580,6418660,2080
2553,FC1,5,6418890,6422850,3960
2554,FA1,8,6422250,6424530,2280
2555,FA1,18,6424580,6428930,4350
2556,FC1,1,6429475,6430025,550
2557,FA1,2,6430310,6430900,590
2558,FA1,2,6432063,6432933,870
2559,CHI,0,6434818,6435398,580
2560,FA1,8,6435858,6438258,2400
2561,CHI,0,6438448,6438988,540
2562,FA1,1,6439018,6439518,500
2563,CHI,0,6439928,6440468,540
2564,FA1,8,6440728,6443458,2730
2565,FA1,10,6443463,6444563,1100
2566,FC1,3,6444583,6445653,1070
2567,FA1,4,6445718,6446618,900
2568,FA1,1,6446718,6447108,390
2569,FC1,3,6447213,6447843,630
2570,FA1,3,6447998,6448528,530
2571,FA1,1,6448543,6448803,260
2572,CHI,0,6460270,6461550,1280
2573,FA1,15,6461590,6464390,2800
2574,FA1,5,6464910,6465850,940
2575,FA1,5,6466310,6466970,660
2576,FA1,5,6468540,6469670,1130
2577,CHI,0,6471685,6472525,840
2578,FA1,19,6472770,6476270,3500
2579,CHI,0,6472775,6474765,1990
2580,FA1,7,6477260,6478250,990
2581,CHI,0,6478655,6478855,200
2582,FA1,1,6478875,6479585,710
2583,CHI,0,6480710,6482700,1990
2584,CHI,0,6482715,6488985,6270
2585,FA1,23,6484565,6489655,5090
2586,FC1,6,6493630,6496000,2370
2587,FA1,10,6496185,6498405,2220
2588,FA1,9,6501415,6504455,3040
2589,FA1,2,6504855,6505605,750
2590,CHI,0,6506330,6509700,3370
2591,FA1,1,6508905,6509705,800
2592,CHI,0,6509885,6510325,440
2593,FA1,4,6510705,6511365,660
2594,CHI,0,6511615,6516785,5170
2595,FA1,16,6513920,6516750,2830
2596,FA1,6,6517145,6518495,1350
2597,FA1,6,6519660,6520620,960
2598,FA1,4,6521160,6522040,880
2599,FA1,4,6522720,6523800,1080
2600,FA1,6,6524160,6525450,1290
2601,FA1,9,6528445,6530395,1950
2602,CHI,0,6530850,6531280,430
2603,FA1,3,6534915,6535975,1060
2604,FC1,9,6537135,6541385,4250
2605,FA1,1,6540710,6541370,660
2606,FC1,2,6542160,6543180,1020
2607,FA1,2,6543170,6543920,750
2608,CHI,0,6544190,6544480,290
2609,CHI,0,6545345,6545765,420
2610,FC1,10,6547335,6554655,7320
2611,FA1,2,6554805,6555575,770
2612,CHI,0,6555850,6556100,250
2613,FC1,7,6556315,6559085,2770
2614,CHI,0,6560240,6560980,740
2615,CHI,0,6562930,6564090,1160
2616,CHI,0,6564210,6565040,830
2617,FC1,2,6566505,6567165,660
2618,FA1,1,6567495,6567935,440
2619,FC1,4,6568055,6569345,1290
2620,FA1,4,6570100,6571130,1030
2621,FC1,6,6570775,6572345,1570
2622,FA1,5,6573020,6574030,1010
2623,FC1,1,6574195,6575555,1360
2624,FA1,1,6575705,6576415,710
2625,FA1,5,6576890,6578500,1610
2626,FA1,7,6580345,6582695,2350
2627,CHI,0,6585230,6585860,630
2628,CHI,0,6588645,6589565,920
2629,CHI,0,6592255,6593485,1230
2630,FA1,3,6594110,6594850,740
2631,CHI,0,6595480,6595640,160
2632,CHI,0,6597260,6599700,2440
2633,FA1,3,6599720,6601190,1470
2634,FA1,2,6601265,6602465,1200
2635,CHI,0,6602405,6602975,570
2636,FA1,4,6603335,6605315,1980
2637,CHI,0,6611145,6611725,580
2638,FC1,14,6611835,6616505,4670
2639,FA1,18,6616690,6619840,3150
2640,FA1,11,6619995,6622125,2130
2641,FA1,9,6628000,6629870,1870
2642,FA1,2,6649125,6649725,600
2643,FA1,6,6651065,6652365,1300
2644,FA1,9,6653795,6655355,1560
2645,FA1,3,6656845,6657565,720
2646,FA1,2,6658235,6658915,680
2647,FA1,3,6659565,6661005,1440
2648,FA1,4,6661245,6662325,1080
2649,FC1,4,6663175,6664375,1200
2650,FA1,4,6664475,6665685,1210
2651,FC1,4,6666250,6667610,1360
2652,FC1,0,6668290,6669850,1560
2653,FC1,4,6670490,6672670,2180
2654,FC1,0,6673160,6676240,3080
2655,FA1,5,6681240,6682090,850
2656,FC1,1,6682255,6682535,280
2657,FA1,8,6682775,6684395,1620
2658,FC1,1,6684425,6684875,450
2659,FC1,5,6690170,6691980,1810
2660,FA1,12,6691760,6694570,2810
2661,FA1,1,6695055,6695235,180
2662,FC1,3,6695325,6697585,2260
2663,FA1,2,6697155,6697575,420
2664,FA1,5,6698105,6698995,890
2665,FC1,5,6699230,6700350,1120
2666,FA1,3,6700520,6701510,990
2667,FA1,0,6708315,6711955,3640
2668,FA1,0,6714255,6716855,2600
2669,FC1,4,6719715,6721415,1700
2670,CHI,0,6722975,6723345,370
2671,CHI,0,6723460,6725130,1670
2672,FC1,0,6727665,6728705,1040
2673,FC1,8,6729605,6733945,4340
2674,FA1,3,6734185,6735355,1170
2675,FC1,3,6735770,6736450,680
2676,FC1,3,6738145,6739405,1260
2677,FC1,3,6740335,6741215,880
2678,FC1,1,6742275,6742805,530
2679,FC1,2,6743870,6744560,690
2680,FA1,3,6745185,6746205,1020
2681,FC1,7,6748105,6751085,2980
2682,FC1,4,6751435,6753005,1570
2683,FC1,5,6753445,6756155,2710
2684,FA1,3,6755430,6756160,730
2685,FC1,0,6756655,6757945,1290
2686,FA1,0,6759010,6760300,1290
2687,FC1,1,6760665,6761035,370
2688,FA1,1,6761475,6761715,240
2689,CHI,0,6773245,6774465,1220
2690,FA1,5,6774525,6775315,790
2691,CHI,0,6775600,6776340,740
2692,FA1,6,6776620,6777620,1000
2693,CHI,0,6777720,6778900,1180
2694,FA1,4,6779190,6780280,1090
2695,CHI,0,6780305,6781035,730
2696,CHI,0,6781850,6782260,410
2697,CHI,0,6782935,6783185,250
2698,FA1,3,6794490,6795020,530
2699,FA1,3,6795545,6796415,870
2700,CHI,0,6801520,6802230,710
2701,FA1,7,6802185,6803505,1320
2702,FA1,8,6804985,6806425,1440
2703,FA1,2,6806925,6807325,400
2704,FC1,0,6807860,6808480,620
2705,FA1,1,6809115,6809605,490
2706,FA1,3,6809710,6810570,860
2707,CHI,0,6812990,6813190,200
2708,CHI,0,6813910,6815420,1510
2709,FA1,2,6814935,6815215,280
2710,FA1,4,6815215,6816745,1530
2711,FC1,3,6817095,6817775,680
2712,FA1,3,6821055,6821585,530
2713,CHI,0,6823200,6823850,650
2714,CHI,0,6824745,6825135,390
2715,CHI,0,6828930,6829540,610
2716,CHI,0,6830905,6831895,990
2717,CHI,0,6833100,6834090,990
2718,FA1,5,6833975,6835835,1860
2719,CHI,0,6835845,6837035,1190
2720,FA1,4,6836810,6837960,1150
2721,FA1,8,6842635,6844365,1730
2722,CHI,0,6843960,6844400,440
2723,FA1,15,6844490,6847860,3370
2724,CHI,0,6847410,6847670,260
2725,FA1,1,6848160,6848500,340
2726,CHI,0,6850850,6851310,460
2727,FA1,2,6851930,6852570,640
2728,CHI,0,6852540,6853100,560
2729,CHI,0,6853880,6854030,150
2730,CHI,0,6855000,6855340,340
2731,CHI,0,6856540,6856800,260
2732,FA1,2,6857240,6857630,390
2733,CHI,0,6859165,6859425,260
2734,FA1,1,6860455,6860855,400
2735,FA1,1,6862085,6862235,150
2736,CHI,0,6863020,6863380,360
2737,CHI,0,6863710,6864080,370
2738,FA1,14,6877633,6881143,3510
2739,FA1,4,6883178,6884778,1600
2740,FC1,1,6884038,6884348,310
2741,FA1,2,6884793,6885403,610
2742,FA1,8,6886548,6889088,2540
2743,FC1,1,6889388,6889688,300
2744,FA1,5,6890908,6891868,960
2745,CHI,0,6901178,6903198,2020
2746,FC1,1,6906768,6907348,580
2747,FA1,3,6907808,6908298,490
2748,FA1,14,6911633,6915073,3440
2749,FC1,9,6917583,6920513,2930
2750,FA1,9,6921158,6922558,1400
2751,FA1,7,6923218,6924028,810
2752,FC1,0,6924183,6924813,630
2753,FA1,7,6925268,6926418,1150
2754,FC1,1,6926453,6927003,550
2755,FA1,1,6926768,6927008,240
2756,CHI,0,6933138,6933458,320
2757,CHI,0,6941336,6942516,1180
2758,CHI,0,6943896,6944736,840
2759,FA1,5,6944696,6945566,870
2760,FA1,1,6946741,6947311,570
2761,CHI,0,6947296,6947846,550
2762,FA1,1,6954551,6954991,440
2763,FC1,8,6958186,6963216,5030
2764,FA1,1,6963541,6963921,380
2765,FA1,12,6964511,6966461,1950
2766,FC1,10,6967311,6970151,2840
2767,FA1,1,6969761,6970021,260
2768,CHI,0,6972551,6973401,850
2769,FA1,17,6973346,6975576,2230
2770,FC1,11,6975721,6982191,6470
2771,CHI,0,6979776,6980416,640
2772,FA1,4,6982456,6983486,1030
2773,FC1,3,6983421,6984541,1120
2774,FA1,3,6984051,6985241,1190
2775,FC1,4,6985586,6987296,1710
2776,FA1,3,6988291,6989391,1100
2777,FC1,1,6989361,6990081,720
2778,FA1,10,6990401,6993181,2780
2779,FC1,3,6993331,6994141,810
2780,FA1,1,6994276,6995076,800
2781,FA1,10,6996376,6997606,1230
2782,CHI,0,6996851,6997621,770
2783,CHI,0,6998096,6999066,970
2784,FA1,2,6999201,7000221,1020
2785,FA1,6,7000481,7001931,1450
2786,FA1,11,7002506,7006326,3820
2787,FA1,14,7006646,7009766,3120
2788,CHI,0,7010616,7011146,530
2789,FA1,6,7014451,7016021,1570
2790,CHI,0,7015991,7017031,1040
2791,FA1,2,7017036,7018316,1280
2792,CHI,0,7018346,7020906,2560
2793,FA1,1,7019196,7019596,400
2794,FC1,3,7020276,7020926,650
2795,CHI,0,7020911,7022761,1850
2796,FC1,1,7022191,7023051,860
2797,FC1,1,7023476,7024176,700
2798,CHI,0,7024196,7025856,1660
2799,CHI,0,7026296,7027016,720
2800,FC1,1,7027036,7028186,1150
2801,FC1,4,7028821,7031231,2410
2802,FA1,5,7031386,7033036,1650
2803,CHI,0,7031711,7033631,1920
2804,FC1,2,7032721,7033161,440
2805,FA1,1,7033591,7034211,620
2806,CHI,0,7034161,7035261,1100
2807,FA1,5,7034211,7036191,1980
2808,FC1,2,7036056,7036956,900
2809,CHI,0,7036081,7037351,1270
2810,FC1,2,7037351,7038261,910
2811,CHI,0,7038246,7039386,1140
2812,CHI,0,7040256,7041956,1700
2813,FA1,7,7041396,7042946,1550
2814,CHI,0,7044926,7046416,1490
2815,CHI,0,7046926,7047866,940
2816,FA1,7,7049091,7050321,1230
2817,CHI,0,7050556,7050796,240
2818,CHI,0,7051081,7051941,860
2819,FA1,6,7058631,7060211,1580
2820,FA1,8,7063681,7065211,1530
2821,CHI,0,7075426,7075686,260
2822,FA1,6,7077366,7079096,1730
2823,FA1,12,7080931,7083091,2160
2824,FC1,1,7083451,7083941,490
2825,FA1,3,7084306,7085806,1500
2826,FA1,10,7088096,7089996,1900
2827,FA1,7,7090626,7092326,1700
2828,FA1,3,7092576,7093236,660
2829,FA1,5,7096836,7097756,920
2830,FA1,6,7102926,7104126,1200
2831,FA1,4,7104346,7105536,1190
2832,FA1,6,7105661,7107401,1740
2833,CHI,0,7107441,7108581,1140
2834,FA1,16,7108741,7110971,2230
2835,FA1,9,7112736,7114256,1520
2836,FA1,6,7115326,7116376,1050
2837,FA1,1,7118251,7118621,370
2838,FA1,1,7122136,7122566,430
2839,FA1,1,7124321,7124571,250
2840,CHI,0,7125246,7127096,1850
2841,FA1,4,7129861,7131091,1230
2842,FA1,5,7133676,7135296,1620
2843,FA1,6,7135406,7137356,1950
2844,FA1,5,7137730,7138570,840
2845,CHI,0,7138800,7139910,1110
2846,FA1,1,7140785,7141085,300
2847,CHI,0,7145305,7145555,250
2848,FA1,4,7147530,7148250,720
2849,CHI,0,7150680,7151290,610
2850,FA1,3,7154385,7154895,510
2851,FA1,5,7156360,7158040,1680
2852,CHI,0,7158320,7158990,670
2853,FA1,2,7159345,7160075,730
2854,FA1,8,7160840,7163120,2280
2855,CHI,0,7163290,7163730,440
2856,CHI,0,7166850,7167130,280
2857,FA1,9,7168600,7169990,1390
2858,CHI,0,7172335,7172635,300
2859,FA1,3,7176865,7178545,1680
2860,CHI,0,7178555,7179855,1300
2861,CHI,0,7180445,7181445,1000
2862,CHI,0,7182155,7182995,840
2863,CHI,0,7183715,7184735,1020
2864,FA1,3,7184275,7185165,890
2865,CHI,0,7185740,7186720,980
2866,FA1,3,7187890,7189240,1350
2867,FC1,0,7188855,7189985,1130
2868,FA1,3,7190080,7191070,990
2869,FA1,2,7192515,7194805,2290
2870,FA1,11,7195950,7200430,4480
2871,FA1,1,7202150,7202740,590
2872,FA1,1,7203085,7204475,1390
2873,FA1,12,7205470,7207510,2040
2874,CHI,0,7210090,7211830,1740
2875,FA1,7,7211870,7212650,780
2876,CHI,0,7212680,7216180,3500
2877,FA1,8,7216780,7218000,1220
2878,FA1,9,7218010,7219810,1800
2879,CHI,0,7220510,7223000,2490
2880,FA1,3,7222215,7223015,800
2881,FA1,2,7224205,7225125,920
2882,CHI,0,7225735,7226035,300
2883,CHI,0,7226255,7226525,270
2884,FA1,6,7233685,7235755,2070
2885,CHI,0,7235750,7236150,400
2886,FA1,9,7236490,7238430,1940
2887,FA1,13,7239180,7241710,2530
2888,CHI,0,7243325,7243545,220
2889,FA1,1,7244215,7244715,500
2890,FA1,14,7244915,7247305,2390
2891,CHI,0,7250710,7251190,480
2892,FA1,6,7251900,7253370,1470
2893,FA1,4,7253520,7254440,920
2894,FA1,2,7255110,7255850,740
2895,FA1,9,7256260,7257580,1320
2896,CHI,0,7274860,7275470,610
2897,CHI,0,7276295,7276705,410
2898,FA1,13,7276770,7278690,1920
2899,FC1,18,7278030,7282300,4270
2900,CHI,0,7282615,7285625,3010
2901,FA1,9,7283480,7284680,1200
2902,FC1,1,7285910,7286520,610
2903,FC1,0,7288385,7289895,1510
2904,FA1,6,7290860,7291950,1090
2905,FA1,6,7292575,7293615,1040
2906,CHI,0,7293750,7294460,710
2907,FA1,1,7294675,7295285,610
2908,FC1,4,7295705,7297365,1660
2909,FA1,1,7297545,7298175,630
2910,FA1,8,7298980,7300370,1390
2911,CHI,0,7303255,7303645,390
2912,CHI,0,7304200,7304790,590
2913,CHI,0,7305825,7306845,1020
2914,FA1,2,7308095,7308725,630
2915,FA1,6,7308870,7309760,890
2916,CHI,0,7313480,7313860,380
2917,CHI,0,7315970,7317120,1150
2918,FA1,5,7317125,7318435,1310
2919,FA1,2,7319080,7319580,500
2920,CHI,0,7319890,7320810,920
2921,FA1,12,7322180,7324930,2750
2922,CHI,0,7331115,7331545,430
2923,CHI,0,7332800,7333140,340
2924,FA1,15,7335850,7337010,1160
2925,FA1,9,7337510,7339460,1950
2926,CHI,0,7344285,7344955,670
2927,CHI,0,7345380,7345850,470
2928,FC1,1,7347335,7347625,290
2929,FA1,2,7347625,7348405,780
2930,FC1,8,7350365,7352935,2570
2931,CHI,0,7352930,7353740,810
2932,FA1,5,7355195,7356695,1500
2933,FA1,17,7357785,7361025,3240
2934,CHI,0,7362170,7362590,420
2935,CHI,0,7362830,7363130,300
2936,FA1,4,7363220,7364740,1520
2937,CHI,0,7366160,7366950,790
2938,FA1,1,7371015,7371955,940
2939,FC1,4,7373625,7374935,1310
2940,FA1,11,7375610,7379240,3630
2941,FA1,1,7385455,7385935,480
2942,FA1,10,7386885,7389505,2620
2943,FA1,6,7390585,7391425,840
2944,CHI,0,7391445,7392875,1430
2945,CHI,0,7395760,7396370,610
2946,FA1,9,7398965,7400605,1640
2947,FA1,11,7401415,7403555,2140
2948,FA1,5,7403645,7405165,1520
2949,FA1,1,7405215,7405785,570
2950,FA1,6,7409310,7410490,1180
2951,FA1,5,7411620,7413680,2060
2952,CHI,0,7413730,7413860,130
2953,FA1,1,7414585,7415195,610
2954,FA1,11,7416840,7419110,2270
2955,FA1,4,7419595,7420585,990
2956,CHI,0,7423700,7424430,730
2957,CHI,0,7426775,7427145,370
2958,FA1,1,7430450,7430960,510
2959,FA1,5,7437505,7439435,1930
2960,FA1,11,7439630,7442050,2420
2961,CHI,0,7443940,7444980,1040
2962,FA1,1,7445010,7445230,220
2963,CHI,0,7447250,7447670,420
2964,FA1,2,7449790,7450610,820
2965,FC1,0,7451000,7451730,730
2966,FA1,3,7452025,7453255,1230
2967,FA1,8,7453370,7454990,1620
2968,FC1,1,7455070,7456270,1200
2969,FA1,5,7460160,7461150,990
2970,CHI,0,7461405,7461965,560
2971,FA1,9,7462165,7463745,1580
2972,FC1,3,7465295,7466895,1600
2973,FA1,2,7467125,7467685,560
2974,CHI,0,7469795,7471025,1230
2975,FA1,5,7471090,7472500,1410
2976,FA1,1,7472615,7472775,160
2977,CHI,0,7473315,7473775,460
2978,FC1,0,7474725,7475495,770
2979,FA1,7,7475100,7476590,1490
2980,CHI,0,7476620,7482410,5790
2981,FA1,6,7476645,7480095,3450
2982,FA1,6,7480405,7482455,2050
2983,FA1,1,7483180,7483630,450
2984,FA1,4,7484325,7485255,930
2985,CHI,0,7485350,7486170,820
2986,FC1,3,7486210,7487350,1140
2987,FA1,5,7487820,7489120,1300
2988,CHI,0,7489140,7490780,1640
2989,FA1,3,7491690,7492520,830
2990,CHI,0,7492125,7494465,2340
2991,FA1,4,7494485,7495605,1120
2992,CHI,0,7498275,7499925,1650
2993,FA1,6,7499905,7501035,1130
2994,CHI,0,7500560,7501980,1420
2995,FA1,4,7501300,7502020,720
2996,FA1,4,7502810,7503730,920
2997,FC1,3,7504810,7506150,1340
2998,FA1,5,7507280,7508210,930
2999,FC1,1,7508405,7508865,460
3000,FA1,1,7509675,7510395,720
3001,FA1,8,7510875,7512995,2120
3002,FC1,4,7513305,7515055,1750
3003,CHI,0,7514440,7515040,600
3004,FA1,1,7515765,7516395,630
3005,CHI,0,7515800,7516930,1130
3006,CHI,0,7517390,7518180,790
3007,FC1,5,7518455,7519955,1500
3008,CHI,0,7518465,7529165,10700
3009,FA1,14,7520745,7524495,3750
3010,FC1,3,7525360,7525960,600
3011,FA1,15,7526135,7529155,3020
3012,FA1,5,7529225,7530745,1520
3013,FA1,8,7531065,7532605,1540
3014,FC1,6,7535745,7537515,1770
3015,FA1,7,7537820,7539250,1430
3016,FC1,0,7540000,7541510,1510
3017,FA1,1,7541795,7542225,430
3018,CHI,0,7543075,7543485,410
3019,FA1,7,7550470,7551960,1490
3020,FA1,10,7552095,7553785,1690
3021,CHI,0,7556990,7557370,380
3022,CHI,0,7558090,7558320,230
3023,CHI,0,7558965,7559205,240
3024,CHI,0,7559965,7560235,270
3025,FA1,8,7560250,7561870,1620
3026,FC1,5,7568430,7569870,1440
3027,FA1,6,7570210,7571880,1670
3028,FA1,2,7572995,7573685,690
3029,FA1,2,7574060,7574480,420
3030,FA1,8,7575170,7577700,2530
3031,FA1,7,7578905,7581075,2170
3032,FA1,4,7581160,7582340,1180
3033,FC1,4,7582390,7584710,2320
3034,FA1,3,7584710,7586200,1490
3035,FC1,15,7585975,7591925,5950
3036,FA1,3,7591120,7591920,800
3037,FA1,3,7591945,7594005,2060
3038,FA1,11,7594635,7596915,2280
3039,FA1,3,7598885,7599685,800
3040,FA1,4,7602805,7603445,640
3041,FC1,0,7604045,7604495,450
3042,FC1,3,7607440,7608540,1100
3043,FA1,3,7608860,7610040,1180
3044,FC1,1,7609840,7610070,230
3045,CHI,0,7613265,7614095,830
3046,CHI,0,7614845,7615275,430
3047,FA1,4,7615320,7615830,510
3048,CHI,0,7616235,7617225,990
3049,FA1,2,7617210,7617640,430
3050,CHI,0,7617775,7618285,510
3051,FA1,1,7618520,7619030,510
3052,FC1,4,7620525,7622405,1880
3053,CHI,0,7620535,7621735,1200
3054,CHI,0,7622375,7622905,530
3055,FA1,7,7622930,7624200,1270
3056,FC1,4,7624345,7625145,800
3057,CHI,0,7624825,7625985,1160
3058,FA1,4,7626125,7627105,980
3059,FC1,4,7627175,7628795,1620
3060,FA1,13,7628855,7632045,3190
3061,CHI,0,7632280,7632890,610
3062,FA1,7,7633025,7634385,1360
3063,FA1,4,7634415,7635485,1070
3064,CHI,0,7638040,7638450,410
3065,CHI,0,7639045,7639515,470
3066,FA1,4,7639470,7640470,1000
3067,FA1,12,7640720,7643190,2470
3068,FC1,0,7643285,7644355,1070
3069,FA1,14,7644570,7647830,3260
3070,FC1,8,7647860,7649470,1610
3071,FA1,2,7649455,7649895,440
3072,FA1,6,7650315,7651635,1320
3073,FC1,4,7652075,7653015,940
3074,FA1,5,7653055,7654045,990
3075,FC1,3,7654425,7655345,920
3076,FA1,3,7655980,7656650,670
3077,CHI,0,7656665,7657335,670
3078,FA1,4,7657300,7658090,790
3079,CHI,0,7658405,7658965,560
3080,FA1,1,7659135,7659555,420
3081,FC1,3,7659575,7660605,1030
3082,FA1,5,7660610,7661980,1370
3083,FA1,11,7663955,7666255,2300
3084,CHI,0,7666255,7667665,1410
3085,CHI,0,7668580,7669150,570
3086,FA1,1,7669345,7669955,610
3087,CHI,0,7670405,7670895,490
3088,FA1,1,7671020,7671570,550
3089,CHI,0,7671935,7672375,440
3090,FA1,1,7672515,7672765,250
3091,CHI,0,7673150,7673390,240
3092,FA1,7,7674280,7676030,1750
3093,FA1,7,7676955,7678655,1700
3094,FA1,6,7680885,7682245,1360
3095,CHI,0,7683005,7683295,290
3096,CHI,0,7683930,7685270,1340
3097,CHI,0,7686220,7688250,2030
3098,FA1,2,7686395,7687065,670
3099,CHI,0,7690260,7691040,780
3100,CHI,0,7691280,7691480,200
3101,CHI,0,7691740,7692360,620
3102,FA1,2,7692310,7692740,430
3103,CHI,0,7692870,7693170,300
3104,FA1,2,7693375,7694485,1110
3105,CHI,0,7696070,7696700,630
3106,CHI,0,7700145,7700575,430
3107,FA1,6,7700690,7702840,2150
3108,FA1,6,7702935,7704285,1350
3109,FA1,6,7705780,7706830,1050
3110,CHI,0,7707345,7707955,610
3111,FA1,2,7708500,7709240,740
3112,FA1,2,7709840,7710700,860
3113,FA1,2,7711240,7713660,2420
3114,FA1,4,7714060,7716560,2500
3115,FA1,3,7716810,7718740,1930
3116,FA1,1,7718775,7719415,640
3117,FA1,1,7719425,7720025,600
3118,FA1,7,7720495,7722865,2370
3119,CHI,0,7722240,7722840,600
3120,FA1,4,7723140,7724070,930
3121,FA1,3,7724975,7725825,850
3122,FA1,2,7727500,7728940,1440
3123,CHI,0,7730900,7731370,470
3124,FA1,4,7732385,7734505,2120
3125,CHI,0,7734505,7738475,3970
3126,FA1,4,7738830,7741090,2260
3127,CHI,0,7745340,7746020,680
3128,FA1,0,7746260,7746730,470
3129,CHI,0,7748575,7749055,480
3130,FA1,9,7749615,7751265,1650
3131,FA1,14,7751300,7754670,3370
3132,CHI,0,7756150,7756720,570
3133,FA1,1,7756805,7757735,930
3134,CHI,0,7757890,7758900,1010
3135,FA1,2,7761000,7761780,780
3136,CHI,0,7763770,7764980,1210
3137,FA1,2,7765405,7766075,670
3138,CHI,0,7765405,7766075,670
3139,CHI,0,7766550,7766800,250
3140,FA1,1,7767265,7767565,300
3141,CHI,0,7769015,7769445,430
3142,FA1,1,7769750,7770530,780
3143,FA1,4,7771760,7775240,3480
3144,FA1,6,7775920,7779590,3670
3145,CHI,0,7783525,7784555,1030
3146,FA1,1,7784930,7785220,290
3147,FA1,2,7790155,7790635,480
3148,CHI,0,7791145,7791775,630
3149,CHI,0,7793040,7793570,530
3150,FA1,2,7796235,7796695,460
3151,FA1,9,7797495,7798755,1260
3152,CHI,0,7799965,7800335,370
3153,FA1,1,7800670,7800950,280
3154,CHI,0,7802470,7802860,390
3155,FC1,2,7804225,7806595,2370
3156,FA1,4,7806980,7808000,1020
3157,FA1,4,7811710,7812290,580
3158,FA1,5,7812500,7813390,890
3159,CHI,0,7813660,7814250,590
3160,FA1,1,7814600,7815440,840
3161,CHI,0,7821970,7823500,1530
3162,FC1,0,7821970,7823500,1530
3163,FA1,7,7823910,7825850,1940
3164,CHI,0,7826085,7826535,450
3165,FC1,12,7826815,7829565,2750
3166,CHI,0,7829845,7830635,790
3167,FC1,8,7831260,7833380,2120
3168,CHI,0,7832240,7833370,1130
3169,FA1,6,7834030,7835620,1590
3170,CHI,0,7835645,7836485,840
3171,FA1,4,7836685,7837535,850
3172,FA1,1,7838470,7838920,450
3173,CHI,0,7842695,7843435,740
3174,FA1,8,7843735,7844945,1210
3175,CHI,0,7845035,7845545,510
3176,FA1,6,7849800,7850720,920
3177,CHI,0,7853730,7854240,510
3178,FA1,6,7854285,7855235,950
3179,FA1,1,7857150,7857350,200
3180,FA1,2,7858370,7858770,400
3181,FA1,2,7859450,7860160,710
3182,FA1,5,7861635,7864885,3250
3183,FA1,2,7865740,7866830,1090
3184,FA1,3,7868025,7869315,1290
3185,FC1,4,7869950,7871010,1060
3186,FA1,4,7871340,7872420,1080
3187,FC1,3,7872600,7873610,1010
3188,FA1,10,7873690,7875770,2080
3189,FA1,1,7881015,7881285,270
3190,FA1,8,7883390,7885160,1770
3191,FC1,0,7894880,7897940,3060
3192,FA1,12,7898580,7901120,2540
3193,FC1,7,7901170,7903320,2150
3194,FA1,4,7903885,7904935,1050
3195,FC1,1,7905070,7905290,220
3196,FA1,1,7905480,7906170,690
3197,FC1,0,7906215,7906835,620
3198,FA1,1,7907345,7907865,520
3199,CHI,0,7910575,7911495,920
3200,FC1,21,7913400,7920530,7130
3201,FA1,13,7920910,7924350,3440
3202,FC1,3,7924870,7925860,990
3203,FA1,6,7927635,7928645,1010
3204,FC1,1,7929180,7929440,260
3205,FA1,1,7929510,7929900,390
3206,FA1,7,7931970,7933410,1440
3207,FC1,1,7938700,7939180,480
3208,FA1,6,7940420,7941640,1220
3209,FC1,3,7941650,7942900,1250
3210,FA1,6,7942935,7944895,1960
3211,FC1,1,7944525,7944915,390
3212,FA1,5,7945060,7946880,1820
3213,FC1,16,7946960,7952470,5510
3214,FA1,2,7952515,7953745,1230
3215,FC1,3,7953740,7954960,1220
3216,CHI,0,7954680,7955330,650
3217,FA1,3,7955515,7956415,900
3218,FA1,6,7956495,7960545,4050
3219,CHI,0,7965500,7965720,220
3220,FA1,1,7971370,7972620,1250
3221,FA1,7,7974705,7977605,2900
3222,CHI,0,7982300,7982590,290
3223,FC1,5,7982685,7984385,1700
3224,FC1,3,7985255,7985745,490
3225,FA1,6,7993965,7997475,3510
3226,CHI,0,8000080,8000550,470
3227,FA1,6,8006545,8008375,1830
3228,FA1,16,8008380,8011230,2850
3229,FA1,1,8012240,8012550,310
3230,FA1,4,8012960,8014260,1300
3231,CHI,0,8014545,8014965,420
3232,FC1,7,8015755,8018685,2930
3233,CHI,0,8016465,8018295,1830
3234,FA1,3,8018660,8019830,1170
3235,CHI,0,8019995,8020545,550
3236,CHI,0,8023930,8024200,270
3237,FA1,4,8028680,8030610,1930
3238,FC1,4,8030305,8031265,960
3239,FA1,6,8031785,8033635,1850
3240,FC1,6,8033440,8034610,1170
3241,FA1,10,8034515,8036855,2340
3242,FC1,1,8037595,8038165,570
3243,FA1,10,8039120,8040620,1500
3244,FA1,1,8040710,8040980,270
3245,FC1,7,8046080,8048780,2700
3246,FA1,11,8049400,8052620,3220
3247,FA1,2,8052820,8054030,1210
3248,FA1,7,8056535,8058445,1910
3249,CHI,0,8057310,8060020,2710
3250,FA1,16,8058835,8061295,2460
3251,FC1,2,8061395,8062085,690
3252,FC1,1,8063850,8064370,520
3253,FC1,1,8065465,8065685,220
3254,FC1,6,8066150,8068160,2010
3255,FA1,1,8068235,8068935,700
3256,FA1,7,8068945,8071355,2410
3257,CHI,0,8069350,8069920,570
3258,CHI,0,8074675,8075255,580
3259,CHI,0,8076515,8076995,480
3260,CHI,0,8077385,8077955,570
3261,CHI,0,8079540,8082510,2970
3262,FA1,7,8080445,8081795,1350
3263,FC1,4,8082990,8084330,1340
3264,CHI,0,8083000,8083670,670
3265,FA1,1,8084660,8085230,570
3266,CHI,0,8084715,8085555,840
3267,CHI,0,8085605,8086575,970
3268,FA1,6,8086770,8088570,1800
3269,CHI,0,8090860,8093280,2420
3270,CHI,0,8094310,8095730,1420
3271,CHI,0,8096450,8096790,340
3272,CHI,0,8097080,8097830,750
3273,CHI,0,8098685,8099235,550
3274,CHI,0,8100080,8100200,120
3275,CHI,0,8100600,8102350,1750
3276,CHI,0,8102785,8104475,1690
3277,FC1,4,8104970,8106240,1270
3278,CHI,0,8106335,8107075,740
3279,FA1,8,8107105,8109355,2250
3280,FA1,9,8110830,8112940,2110
3281,CHI,0,8114105,8114355,250
3282,CHI,0,8115140,8115820,680
3283,CHI,0,8117610,8118040,430
3284,FA1,16,8117865,8121775,3910
3285,FC1,0,8127900,8128380,480
3286,CHI,0,8129090,8129460,370
3287,CHI,0,8130815,8131065,250
3288,CHI,0,8131710,8132060,350
3289,CHI,0,8132205,8133565,1360
3290,CHI,0,8134655,8134975,320
3291,CHI,0,8136325,8136665,340
3292,FC1,0,8136695,8137915,1220
3293,CHI,0,8138235,8138805,570
3294,FC1,4,8139700,8140810,1110
3295,CHI,0,8140370,8140800,430
3296,FA1,5,8141125,8142755,1630
3297,FC1,1,8143620,8144220,600
3298,FC1,2,8144700,8146000,1300
3299,CHI,0,8150715,8151255,540
3300,FA1,8,8151360,8153320,1960
3301,CHI,0,8153500,8153850,350
3302,CHI,0,8154555,8154815,260
3303,FC1,3,8154865,8155495,630
3304,FC1,3,8156590,8159430,2840
3305,CHI,0,8160900,8161250,350
3306,FC1,4,8162815,8164765,1950
3307,FA1,1,8165050,8165560,510
3308,CHI,1,8165905,8166495,590
3309,CHI,0,8167950,8168310,360
3310,CHI,0,8176720,8176960,240
3311,FC1,0,8177690,8185710,8020
3312,FA1,2,8185710,8186260,550
3313,FA1,7,8187535,8188855,1320
3314,FC1,8,8189785,8196755,6970
3315,CHI,0,8193830,8194180,350
3316,CHI,0,8197105,8197825,720
3317,FA1,13,8197555,8200495,2940
3318,CHI,0,8200505,8200895,390
3319,CHI,0,8201000,8201180,180
3320,CHI,0,8203020,8203440,420
3321,CHI,0,8206980,8207240,260
3322,CHI,0,8214970,8216000,1030
3323,FA1,14,8217830,8221150,3320
3324,CHI,0,8227650,8228030,380
3325,CHI,0,8231490,8232110,620
3326,CHI,0,8236080,8236520,440
3327,FA1,5,8242860,8243550,690
3328,CHI,0,8243665,8244185,520
3329,FA1,3,8243825,8245125,1300
3330,CHI,0,8244635,8245725,1090
3331,CHI,0,8246250,8247040,790
3332,CHI,0,8247745,8248835,1090
3333,FA1,5,8248495,8250165,1670
3334,CHI,0,8249270,8250130,860
3335,CHI,0,8250940,8252010,1070
3336,CHI,0,8252645,8253285,640
3337,FC1,3,8256765,8257495,730
3338,FA1,4,8259960,8261920,1960
3339,FC1,5,8262010,8263650,1640
3340,FA1,8,8263760,8265830,2070
3341,FA1,5,8267650,8269470,1820
3342,FA1,12,8270380,8273640,3260
3343,FC1,7,8274830,8278110,3280
3344,FC1,4,8278170,8280220,2050
3345,FC1,3,8280505,8285095,4590
3346,FA1,6,8284785,8286595,1810
3347,FA1,4,8286960,8288040,1080
3348,FC1,3,8288230,8289300,1070
3349,FC1,2,8290415,8291215,800
3350,CHI,0,8292695,8293325,630
3351,FA1,3,8293580,8294430,850
3352,CHI,0,8294845,8294985,140
3353,CHI,0,8296105,8296635,530
3354,FA1,2,8297730,8298110,380
3355,FC1,2,8298310,8299000,690
3356,FC1,10,8299825,8301935,2110
3357,FA1,4,8301960,8302960,1000
3358,FC1,1,8303190,8303380,190
3359,FA1,13,8305105,8308365,3260
3360,FA1,1,8309625,8309825,200
3361,FA1,1,8311445,8311875,430
3362,FC1,0,8313120,8313610,490
3363,FA1,0,8314355,8315025,670
3364,FA1,9,8316035,8318245,2210
3365,FC1,19,8318690,8325680,6990
3366,FA1,1,8325855,8326745,890
3367,FC1,6,8328560,8330090,1530
3368,FA1,4,8330345,8331605,1260
3369,CHI,0,8332035,8334655,2620
3370,FA1,3,8334905,8336525,1620
3371,CHI,0,8336555,8337395,840
3372,CHI,0,8339575,8339825,250
3373,CHI,0,8340120,8340490,370
3374,FA1,14,8341115,8344065,2950
3375,CHI,0,8345210,8345540,330
3376,CHI,0,8345925,8346285,360
3377,FA1,11,8349895,8351915,2020
3378,FC1,3,8354920,8356040,1120
3379,CHI,0,8356335,8357265,930
3380,FA1,6,8356660,8358230,1570
3381,FC1,1,8358465,8358845,380
3382,FA1,1,8358865,8359175,310
3383,FC1,13,8359520,8366800,7280
3384,CHI,0,8362380,8362620,240
3385,FA1,2,8366430,8367190,760
3386,FA1,9,8369490,8371610,2120
3387,FC1,7,8371830,8374450,2620
3388,CHI,0,8376030,8376780,750
3389,FC1,6,8377325,8380175,2850
3390,FA1,6,8380150,8382100,1950
3391,CHI,0,8382965,8383415,450
3392,CHI,0,8383890,8384410,520
3393,CHI,0,8386310,8386440,130
3394,CHI,0,8387155,8387565,410
3395,CHI,0,8387730,8388320,590
3396,FA1,2,8388515,8389065,550
3397,CHI,0,8389060,8389610,550
3398,FC1,12,8389990,8396420,6430
3399,FA1,3,8391405,8392455,1050
3400,CHI,0,8393955,8394555,600
3401,CHI,0,8395125,8396455,1330
3402,FC1,12,8396520,8400630,4110
3403,FA1,3,8400675,8402095,1420
3404,FC1,1,8402125,8402835,710
3405,FA1,3,8403650,8405340,1690
3406,FA1,10,8405375,8407555,2180
3407,FC1,1,8407615,8407835,220
3408,FA1,13,8408340,8410090,1750
3409,CHI,0,8408600,8409090,490
3410,FC1,2,8411445,8413045,1600
3411,FA1,3,8413115,8414015,900
3412,FC1,2,8414245,8415715,1470
3413,FA1,1,8415220,8416730,1510
3414,FC1,3,8417065,8418835,1770
3415,FA1,1,8418010,8419450,1440
3416,CHI,0,8418530,8418840,310
3417,FC1,4,8419655,8421305,1650
3418,CHI,0,8421360,8421760,400
3419,FC1,7,8424380,8427890,3510
3420,CHI,0,8425285,8425635,350
3421,FA1,12,8428220,8431350,3130
3422,CHI,0,8428870,8429400,530
3423,CHI,0,8429815,8430465,650
3424,FC1,4,8431585,8434625,3040
3425,CHI,0,8433160,8433610,450
3426,CHI,0,8434115,8434305,190
3427,FA1,1,8435575,8437285,1710
3428,FA1,0,8438460,8438890,430
3429,FA1,1,8439445,8439665,220
3430,CHI,1,8440075,8440945,870
3431,FA1,2,8441670,8443100,1430
3432,CHI,0,8443085,8443865,780
3433,FA1,4,8444655,8445665,1010
3434,CHI,0,8445730,8446140,410
3435,CHI,0,8446345,8446825,480
3436,FA1,6,8446625,8447905,1280
3437,FA1,1,8451010,8452020,1010
3438,CHI,0,8451995,8452525,530
3439,FA1,1,8453100,8454450,1350
3440,CHI,0,8454455,8454795,340
3441,FA1,1,8455075,8455295,220
3442,CHI,0,8455550,8455850,300
3443,FA1,9,8456280,8458280,2000
3444,FA1,5,8459240,8460890,1650
3445,CHI,0,8460995,8461265,270
3446,CHI,0,8463080,8464080,1000
3447,FA1,5,8464130,8465330,1200
3448,CHI,0,8465830,8466570,740
3449,FA1,6,8466675,8467835,1160
3450,CHI,0,8467705,8468675,970
3451,FA1,3,8469415,8470085,670
3452,FC1,1,8470140,8470540,400
3453,CHI,0,8472090,8472730,640
3454,FA1,1,8472840,8473730,890
3455,FA1,5,8475375,8477255,1880
3456,CHI,1,8477275,8478025,750
3457,FA1,2,8478010,8478920,910
3458,CHI,1,8479215,8479755,540
3459,FA1,1,8479995,8480735,740
3460,CHI,0,8481055,8481345,290
3461,FA1,2,8481690,8482380,690
3462,CHI,0,8483445,8484235,790
3463,FA1,6,8484900,8486340,1440
3464,CHI,0,8486380,8489390,3010
3465,FA1,2,8487370,8488570,1200
3466,FA1,3,8491015,8491665,650
3467,FA1,1,8492060,8493740,1680
3468,FA1,1,8494320,8495600,1280
3469,FA1,3,8495720,8497310,1590
3470,FC1,0,8497335,8497805,470
3471,FA1,0,8497810,8498660,850
3472,FC1,7,8499095,8501005,1910
3473,FA1,0,8500140,8500980,840
3474,FC1,3,8501020,8501870,850
3475,FA1,1,8501900,8502370,470
3476,FA1,9,8503945,8507165,3220
3477,CHI,0,8509395,8510075,680
3478,FA1,1,8510135,8510535,400
3479,CHI,0,8510925,8511185,260
3480,FA1,4,8512615,8515275,2660
3481,FA1,1,8515425,8516515,1090
3482,CHI,0,8516470,8517040,570
3483,FA1,1,8517225,8517445,220
3484,CHI,0,8518125,8518495,370
3485,FA1,1,8518750,8519020,270
3486,CHI,0,8520745,8521475,730
3487,CHI,0,8522950,8523320,370
3488,FC1,0,8523575,8524565,990
3489,FA1,4,8524560,8526700,2140
3490,FA1,2,8527530,8529010,1480
3491,FA1,2,8534420,8537070,2650
3492,CHI,0,8537095,8537555,460
3493,FA1,3,8537725,8538685,960
3494,FC1,0,8538335,8541425,3090
3495,FC1,0,8542010,8542820,810
3496,FA1,11,8542925,8545935,3010
3497,FC1,1,8545980,8547070,1090
3498,FA1,7,8547905,8550215,2310
3499,FC1,1,8550310,8552820,2510
3500,FA1,5,8552300,8553870,1570
3501,FC1,1,8553885,8555655,1770
3502,CHI,0,8555865,8556335,470
3503,FC1,1,8557470,8558640,1170
3504,CHI,1,8559535,8559725,190
3505,FC1,0,8559880,8560780,900
3506,FA1,14,8560820,8563970,3150
3507,CHI,0,8564685,8566025,1340
3508,FC1,3,8566395,8567645,1250
3509,FA1,3,8567870,8568680,810
3510,FC1,3,8568755,8569675,920
3511,FA1,1,8570115,8570655,540
3512,FC1,3,8571945,8573175,1230
3513,FA1,3,8573310,8574110,800
3514,FA1,6,8575080,8576950,1870
3515,FA1,4,8577055,8578055,1000
3516,FC1,11,8578735,8582385,3650
3517,CHI,0,8582440,8582940,500
3518,CHI,0,8583180,8583870,690
3519,FC1,0,8584865,8586525,1660
3520,CHI,0,8585185,8586525,1340
3521,FC1,10,8586695,8589425,2730
3522,CHI,0,8590310,8591200,890
3523,CHI,0,8592095,8593615,1520
3524,CHI,0,8594045,8594835,790
3525,FA1,12,8596250,8598840,2590
3526,FC1,1,8598225,8598515,290
3527,FA1,5,8599060,8599840,780
3528,FC1,19,8600200,8605770,5570
3529,FA1,4,8605315,8606855,1540
3530,FC1,12,8608045,8614965,6920
3531,CHI,0,8615395,8616325,930
3532,CHI,0,8616550,8617570,1020
3533,CHI,0,8624360,8624720,360
3534,FA1,5,8628670,8630660,1990
3535,FC1,0,8631955,8633715,1760
3536,FA1,3,8634275,8634865,590
3537,FC1,0,8635100,8636030,930
3538,FA1,18,8635395,8640275,4880
3539,FA1,12,8643045,8645065,2020
3540,FA1,5,8646110,8647140,1030
3541,FA1,8,8648155,8649575,1420
3542,FA1,5,8650255,8651735,1480
3543,CHI,0,8654005,8654475,470
3544,FA1,5,8655860,8658000,2140
3545,FA1,5,8666450,8669280,2830
3546,CHI,0,8669815,8670185,370
3547,CHI,0,8670490,8670730,240
3548,FA1,3,8673490,8674270,780
3549,FC1,3,8677620,8679250,1630
3550,FA1,3,8679710,8680960,1250
3551,CHI,0,8683505,8684015,510
3552,FA1,5,8686940,8688090,1150
3553,FA1,5,8688805,8690525,1720
3554,FA1,4,8690655,8691425,770
3555,CHI,0,8701570,8702050,480
3556,FA1,12,8702920,8707850,4930
3557,FA1,0,8709320,8711390,2070
3558,FA1,7,8711430,8712910,1480
3559,FA1,3,8714475,8715755,1280
3560,CHI,0,8716665,8716955,290
3561,CHI,0,8717050,8717480,430
3562,FA1,1,8717535,8718085,550
3563,FC1,5,8718320,8720120,1800
3564,FC1,0,8720250,8721470,1220
3565,FA1,1,8725070,8725240,170
3566,FA1,4,8726585,8727445,860
3567,FA1,4,8731615,8732315,700
3568,CHI,0,8733115,8733415,300
3569,FA1,11,8735215,8737945,2730
3570,FC1,10,8738120,8742440,4320
3571,FA1,8,8743880,8745470,1590
3572,FC1,2,8745705,8746745,1040
3573,FA1,10,8746975,8749435,2460
3574,FA1,1,8757635,8758135,500
3575,CHI,0,8760245,8760535,290
3576,CHI,0,8761070,8761480,410
3577,FA1,1,8761615,8761975,360
3578,FC1,6,8762745,8765195,2450
3579,FA1,9,8765330,8767420,2090
3580,FA1,10,8768095,8769935,1840
3581,FA1,1,8769975,8770305,330
3582,FC1,5,8770250,8770960,710
3583,FA1,10,8770960,8773260,2300
3584,CHI,0,8773350,8773690,340
3585,FA1,10,8774160,8776800,2640
3586,FA1,6,8776990,8778510,1520
3587,FA1,6,8778760,8780700,1940
3588,CHI,0,8780710,8781070,360
3589,FA1,15,8781310,8783680,2370
3590,FA1,3,8783775,8784425,650
3591,FA1,6,8784940,8786900,1960
3592,FA1,4,8788630,8790150,1520
3593,FA1,6,8798190,8799060,870
3594,FA1,7,8799925,8801905,1980
3595,FA1,8,8802955,8805485,2530
3596,FA1,5,8805530,8806720,1190
3597,FA1,9,8807405,8809065,1660
3598,FA1,10,8809655,8811935,2280
3599,FC1,1,8811335,8812825,1490
3600,FA1,14,8813800,8816810,3010
3601,FC1,4,8827030,8828420,1390
3602,CHI,0,8828045,8828375,330
3603,FA1,1,8828430,8829190,760
3604,FC1,1,8832640,8833090,450
3605,FA1,7,8834735,8843225,8490
3606,FC1,4,8835560,8836290,730
3607,FC1,4,8844990,8846750,1760
3608,FA1,9,8847020,8849160,2140
3609,FA1,8,8849585,8852875,3290
3610,FA1,2,8853570,8854250,680
3611,FA1,11,8855540,8859420,3880
3612,FC1,3,8859070,8861250,2180
3613,FA1,5,8862000,8864110,2110
3614,FA1,1,8868575,8869695,1120
3615,FA1,7,8872215,8873825,1610
3616,FA1,4,8877250,8879380,2130
3617,FC1,4,8878455,8879705,1250
3618,FA1,6,8880350,8881430,1080
3619,FC1,1,8884250,8884480,230
3620,FA1,7,8886545,8888075,1530
3621,FA1,13,8889430,8892230,2800
3622,FA1,1,8893330,8893710,380
3623,FA1,18,8894480,8898860,4380
3624,FA1,9,8900000,8903420,3420
3625,FC1,4,8902715,8903415,700
3626,FA1,3,8904950,8906180,1230
3627,FA1,7,8911285,8913685,2400
3628,FC1,1,8911835,8912315,480
3629,FA1,9,8914315,8917345,3030
3630,FA1,4,8921295,8922505,1210
3631,FA1,1,8924290,8924750,460
3632,FA1,6,8925440,8927560,2120
3633,FA1,3,8928270,8928950,680
3634,FC1,4,8928960,8929920,960
3635,FA1,7,8930320,8931710,1390
3636,CHI,0,8932855,8934245,1390
3637,FA1,2,8934020,8934650,630
3638,CHI,0,8935120,8941580,6460
3639,FA1,4,8935505,8936675,1170
3640,FA1,0,8937340,8939010,1670
3641,FA1,4,8940735,8941605,870
3642,FA1,7,8941980,8942850,870
3643,CHI,0,8944315,8944505,190
3644,CHI,0,8946080,8948570,2490
3645,CHI,0,8951405,8954095,2690
3646,CHI,0,8955410,8957420,2010
3647,CHI,0,8958005,8960705,2700
3648,CHI,0,8961455,8967545,6090
3649,CHI,0,8970300,8971760,1460
3650,CHI,0,8979910,8982820,2910
3651,CHI,0,8983660,8985780,2120
3652,CHI,0,8986815,8990045,3230
3653,CHI,0,8990220,8993090,2870
3654,CHI,0,8994675,8994905,230
3655,CHI,0,8995450,8995670,220
3656,CHI,0,8996275,8996485,210
3657,CHI,0,8997640,9002600,4960
3658,CHI,0,9003100,9004220,1120
3659,CHI,0,9006400,9007730,1330
3660,CHI,0,9010395,9012595,2200
3661,CHI,0,9013105,9014845,1740
3662,CHI,0,9015265,9017415,2150
3663,CHI,0,9030400,9030780,380
3664,CHI,0,9037730,9038180,450
3665,CHI,0,9038845,9039135,290
3666,CHI,0,9067710,9067900,190
3667,CHI,0,9074665,9074845,180
3668,CHI,0,9077795,9078095,300
3669,CHI,0,9095245,9096755,1510
3670,CHI,0,9100830,9101050,220
3671,CHI,0,9103700,9104440,740
3672,CHI,0,9111500,9111660,160
3673,CHI,0,9121470,9122180,710
3674,CHI,0,9122665,9123195,530
3675,CHI,0,9125120,9125280,160
3676,CHI,0,9126510,9126670,160
3677,CHI,0,9128510,9128890,380
3678,CHI,0,9130370,9130580,210
3679,CHI,0,9132465,9132795,330
3680,CHI,0,9140020,9141280,1260
3681,CHI,0,9150421,9152281,1860
3682,CHI,0,9154101,9154491,390
3683,CHI,0,9169571,9169741,170
3684,CHI,0,9178866,9179996,1130
3685,CHI,0,9186271,9186621,350
3686,CHI,0,9189986,9190286,300
3687,CHI,0,9238846,9239736,890
3688,CHI,0,9239971,9240241,270
3689,CHI,0,9242016,9242666,650
3690,CHI,0,9244311,9245271,960
3691,CHI,0,9249961,9250171,210
3692,CHI,0,9255306,9255876,570
3693,CHI,0,9257011,9257621,610
3694,CHI,0,9257836,9260376,2540
3695,CHI,0,9261436,9266586,5150
3696,CHI,0,9268611,9268981,370
3697,CHI,0,9271066,9271816,750
3698,CHI,0,9272831,9273201,370
3699,CHI,0,9277966,9278486,520
3700,CHI,0,9278676,9279376,700
3701,CHI,0,9279646,9279976,330
3702,CHI,0,9281911,9282731,820
3703,CHI,0,9302831,9303411,580
3704,CHI,0,9316501,9317051,550
3705,CHI,0,9319196,9319826,630
3706,CHI,0,9322736,9323886,1150
3707,CHI,0,9326601,9327161,560
3708,CHI,0,9335441,9336101,660
3709,CHI,0,9350341,9350731,390
3710,CHI,0,9361626,9361966,340
3711,CHI,0,9364326,9364606,280
3712,CHI,0,9366656,9367106,450
3713,CHI,0,9374141,9376221,2080
3714,CHI,0,9415131,9417051,1920
3715,CHI,0,9435591,9437221,1630
3716,CHI,0,9478931,9479141,210
3717,CHI,0,9482866,9482956,90
3718,CHI,0,9485921,9486211,290
3719,CHI,0,9489316,9489466,150
3720,CHI,0,9493161,9494031,870
3721,CHI,0,9501806,9502026,220
3722,CHI,0,9504496,9504736,240
3723,CHI,0,9506626,9507006,380
3724,CHI,0,9509966,9510266,300
3725,CHI,0,9513596,9513806,210
3726,CHI,0,9518121,9518391,270
3727,CHI,0,9521906,9522186,280
3728,CHI,0,9526936,9527096,160
3729,CHI,0,9561330,9561500,170
3730,CHI,0,9562345,9562505,160
3731,CHI,0,9592640,9592780,140
3732,CHI,0,9597360,9597490,130
3733,CHI,0,9598375,9598505,130
3734,CHI,0,9601650,9601880,230
3735,CHI,0,9604145,9604315,170
3736,CHI,0,9610860,9610960,100
3737,CHI,0,9611340,9611430,90
3738,CHI,0,9626245,9626415,170
3739,CHI,0,9626940,9627190,250
3740,CHI,0,9627565,9627985,420
3741,CHI,0,9631005,9631205,200
3742,CHI,0,9652085,9652525,440
3743,CHI,0,9653645,9654555,910
3744,CHI,0,9656240,9656900,660
3745,CHI,0,9661160,9662160,1000
3746,CHI,0,9663950,9665230,1280
3747,CHI,0,9667570,9668680,1110
3748,CHI,0,9672405,9673405,1000
3749,CHI,0,9680625,9680775,150
3750,CHI,0,9682040,9682130,90
3751,CHI,0,9697045,9697215,170
3752,CHI,0,9700310,9700520,210
3753,CHI,0,9703155,9703335,180
3754,CHI,0,9708245,9708835,590
3755,CHI,0,9713260,9713420,160
3756,CHI,0,9716060,9716240,180
3757,CHI,0,9718550,9718750,200
3758,CHI,0,9722375,9722615,240
3759,CHI,0,9724335,9724485,150
3760,CHI,0,9725760,9726140,380
3761,CHI,0,9726940,9727110,170
3762,CHI,0,9727715,9727905,190
3763,CHI,0,9729820,9730000,180
3764,CHI,0,9732550,9732740,190
3765,CHI,0,9736225,9736385,160
3766,CHI,0,9740035,9740305,270
3767,CHI,0,9784625,9784855,230
3768,CHI,0,9804820,9805000,180
3769,CHI,0,9810610,9810990,380
3770,CHI,0,9816550,9816870,320
3771,CHI,0,9827940,9828170,230
3772,CHI,0,9832715,9833535,820
3773,CHI,0,9838915,9839285,370
3774,CHI,0,9839740,9839920,180
3775,CHI,0,9840530,9841060,530
3776,CHI,0,9842355,9843275,920
3777,CHI,0,9844315,9844915,600
3778,CHI,0,9847365,9847585,220
3779,CHI,0,9849355,9849685,330
3780,CHI,0,9851000,9851760,760
3781,CHI,0,9853980,9854250,270
3782,CHI,0,9855555,9855845,290
3783,CHI,0,9859480,9859830,350
3784,CHI,0,9860985,9864465,3480
3785,CHI,0,9868500,9869650,1150
3786,CHI,0,9870635,9870975,340
3787,CHI,0,9873965,9876175,2210
3788,CHI,0,9877050,9877960,910
3789,CHI,0,9879045,9879765,720
3790,CHI,0,9893365,9893665,300
3791,CHI,0,9896605,9897245,640
3792,CHI,0,9898105,9898865,760
3793,CHI,0,9899005,9899605,600
3794,CHI,0,9899785,9902975,3190
3795,CHI,0,9903810,9903950,140
3796,CHI,0,9905240,9905710,470
3797,CHI,0,9908205,9908585,380
3798,CHI,0,9910725,9911425,700
3799,CHI,0,9911755,9911935,180
3800,CHI,0,9913515,9914255,740
3801,CHI,0,9914485,9915405,920
3802,CHI,0,9916475,9918925,2450
3803,CHI,0,9920860,9923400,2540
3804,CHI,0,9924250,9925240,990
3805,CHI,0,9925995,9926875,880
3806,CHI,0,9927395,9928265,870
3807,CHI,0,9928690,9929240,550
3808,CHI,0,9929905,9930055,150
3809,CHI,0,9930690,9931030,340
3810,CHI,0,9931650,9933060,1410
3811,CHI,0,9934685,9934985,300
3812,CHI,0,9936155,9936815,660
3813,CHI,0,9937755,9938095,340
3814,CHI,0,9938725,9941905,3180
3815,CHI,0,9942545,9943895,1350
3816,CHI,0,9944590,9945930,1340
3817,CHI,0,9946640,9947610,970
3818,CHI,0,9948660,9950860,2200
3819,CHI,0,9951170,9952180,1010
3820,CHI,0,9953305,9954535,1230
3821,CHI,0,9955300,9955720,420
3822,CHI,0,9956710,9958220,1510
3823,CHI,0,9960695,9961645,950
3824,CHI,0,9961840,9963160,1320
3825,CHI,0,9963940,9965110,1170
3826,CHI,0,9965255,9965745,490
3827,CHI,0,9965900,9967850,1950
3828,CHI,0,9968475,9969205,730
3829,CHI,0,9970310,9971360,1050
3830,CHI,0,9972105,9972455,350
3831,CHI,0,9980140,9980250,110
3832,CHI,0,9981285,9981425,140
3833,CHI,0,9991615,9991845,230
3834,CHI,0,9997300,9999490,2190
3835,CHI,0,10002515,10004345,1830
3836,CHI,0,10005700,10005860,160
3837,CHI,0,10033580,10033730,150
3838,CHI,0,10049805,10050005,200
3839,CHI,0,10054525,10054735,210
3840,CHI,0,10055605,10055945,340
3841,CHI,0,10056705,10057535,830
3842,CHI,0,10057910,10059900,1990
3843,CHI,0,10060185,10061655,1470
3844,CHI,0,10066890,10067020,130
3845,CHI,0,10071925,10072325,400
3846,CHI,0,10073355,10075295,1940
3847,CHI,0,10076205,10076435,230
3848,CHI,0,10081080,10081230,150
3849,CHI,0,10083870,10083990,120
3850,CHI,0,10090450,10092450,2000
3851,CHI,0,10093650,10094000,350
3852,CHI,0,10094895,10095115,220
3853,CHI,0,10095445,10095975,530
3854,CHI,0,10096560,10096830,270
3855,CHI,0,10097505,10100045,2540
3856,CHI,0,10101105,10102735,1630
3857,CHI,0,10113210,10114940,1730
3858,CHI,0,10115335,10120025,4690
3859,CHI,0,10120320,10121600,1280
3860,CHI,0,10121960,10124560,2600
3861,CHI,0,10126610,10132320,5710
3862,CHI,0,10133455,10134045,590
3863,CHI,0,10135240,10135900,660
3864,CHI,0,10139995,10145545,5550
3865,CHI,0,10146770,10147550,780
3866,CHI,0,10148260,10150870,2610
3867,CHI,0,10151625,10152365,740
3868,CHI,0,10168323,10170543,2220
3869,CHI,0,10172053,10172953,900
3870,CHI,0,10177053,10181203,4150
3871,CHI,0,10184108,10186078,1970
3872,CHI,0,10187783,10192433,4650
3873,CHI,0,10201268,10204828,3560
3874,CHI,0,10204998,10205238,240
3875,CHI,0,10206308,10207228,920
3876,CHI,0,10209858,10210698,840
3877,CHI,0,10211138,10212158,1020
3878,CHI,0,10212658,10213428,770
3879,CHI,0,10215083,10216003,920
3880,CHI,0,10218363,10218893,530
3881,CHI,0,10228278,10230408,2130
3882,CHI,0,10231068,10234148,3080
3883,CHI,0,10235203,10236643,1440
3884,CHI,0,10237293,10239253,1960
3885,CHI,0,10240473,10241233,760
3886,CHI,0,10332313,10333023,710
3887,CHI,0,10334658,10334938,280
3888,CHI,0,10340608,10342108,1500
3889,CHI,0,10342238,10342498,260
3890,CHI,0,10342768,10344688,1920
3891,CHI,0,10344808,10346918,2110
3892,CHI,0,10347433,10349053,1620
3893,CHI,0,10350083,10351833,1750
3894,CHI,0,10353978,10354948,970
3895,CHI,0,10355203,10355403,200
3896,CHI,0,10356093,10356383,290
3897,CHI,0,10356943,10357193,250
3898,CHI,0,10358838,10359098,260
3899,CHI,0,10359718,10361258,1540
3900,CHI,0,10364058,10364348,290
3901,CHI,0,10364623,10373593,8970
3902,CHI,0,10374618,10375088,470
3903,CHI,0,10375463,10376133,670
3904,CHI,0,10376478,10376598,120
3905,CHI,0,10376948,10377108,160
3906,CHI,0,10377458,10377658,200
3907,CHI,0,10378098,10378418,320
3908,CHI,0,10386998,10387928,930
3909,CHI,0,10388363,10388663,300
3910,CHI,0,10462338,10462688,350
3911,CHI,0,10515633,10515823,190
3912,CHI,0,15955556,15955806,250
3913,CHI,0,15962921,15963221,300
3914,CHI,0,15972056,15972686,630
3915,CHI,0,15983471,15983861,390
3916,CHI,0,15989066,15989256,190
3917,CHI,0,16002041,16002311,270
3918,CHI,0,16003166,16003436,270
3919,CHI,0,16031801,16031971,170
3920,CHI,0,16032636,16032916,280
3921,CHI,0,16037916,16038146,230
3922,CHI,0,16046051,16046681,630
3923,CHI,0,16063296,16063556,260
3924,CHI,0,16085056,16085856,800
3925,CHI,0,16086881,16087541,660
3926,CHI,0,16089901,16090331,430
3927,CHI,0,16101276,16101566,290
3928,CHI,0,16104921,16105151,230
3929,CHI,1,16112136,16112946,810
3930,CHI,0,16131081,16131481,400
3931,CHI,0,16136421,16136661,240
3932,CHI,0,16138041,16138391,350
3933,CHI,0,16157906,16158116,210
3934,CHI,0,16174251,16174581,330
3935,CHI,0,16207566,16208836,1270
3936,CHI,0,16217261,16217391,130
3937,CHI,0,16228106,16228916,810
3938,CHI,0,16235531,16235711,180
3939,CHI,0,16245445,16245585,140
3940,CHI,0,16250425,16250685,260
3941,CHI,0,16254125,16254345,220
3942,CHI,0,16260085,16260735,650
3943,CHI,0,16262290,16262730,440
3944,CHI,0,16286360,16286420,60
3945,CHI,0,16287410,16287750,340
3946,CHI,0,16288570,16288690,120
3947,CHI,0,16294540,16294830,290
3948,CHI,0,16295945,16296385,440
3949,CHI,0,16298525,16298745,220
3950,CHI,0,16300225,16300465,240
3951,CHI,0,16302135,16302355,220
3952,CHI,0,16304635,16304875,240
3953,CHI,0,16309585,16309785,200
3954,CHI,0,16316715,16316985,270
3955,CHI,0,16325911,16326411,500
3956,FA1,6,16326711,16328251,1540
3957,CHI,0,16330071,16330401,330
3958,FA1,1,16330696,16330956,260
3959,CHI,0,16332116,16332706,590
3960,FA1,7,16333161,16334781,1620
3961,FA1,4,16337381,16338871,1490
3962,FA1,3,16339791,16341561,1770
3963,CHI,0,16341806,16341986,180
3964,FA1,1,16342586,16343306,720
3965,CHI,0,16343736,16344306,570
3966,FA1,1,16344461,16344991,530
3967,CHI,0,16346766,16347016,250
3968,FA1,1,16347441,16347901,460
3969,FA1,1,16348331,16348611,280
3970,CHI,0,16349921,16350121,200
3971,FA1,1,16350731,16350911,180
3972,CHI,0,16352071,16352261,190
3973,FA1,10,16353356,16354716,1360
3974,CHI,0,16355076,16355286,210
3975,CHI,0,16355541,16355661,120
3976,FA1,1,16356296,16357326,1030
3977,CHI,0,16357901,16358221,320
3978,FA1,7,16358411,16359671,1260
3979,FA1,10,16361046,16362956,1910
3980,CHI,0,16364641,16364911,270
3981,FA1,2,16365136,16366386,1250
3982,CHI,0,16367581,16368241,660
3983,FA1,1,16368411,16368551,140
3984,CHI,0,16370891,16371271,380
3985,FA1,1,16371471,16371671,200
3986,CHI,0,16377031,16377231,200
3987,FA1,1,16377441,16377661,220
3988,FA1,7,16378741,16380651,1910
3989,FA1,6,16381846,16382616,770
3990,CHI,0,16383541,16387861,4320
3991,FA1,10,16384891,16387241,2350
3992,FA1,1,16388286,16389126,840
3993,FA1,1,16390126,16391376,1250
3994,FA1,3,16392521,16393581,1060
3995,CHI,0,16393261,16394181,920
3996,FA1,2,16394961,16395401,440
3997,FA1,2,16395571,16396881,1310
3998,CHI,0,16397086,16402746,5660
3999,FA1,10,16397776,16401186,3410
4000,FA1,3,16402211,16403561,1350
4001,FA1,4,16405246,16407346,2100
4002,CHI,0,16405246,16407346,2100
4003,CHI,0,16407746,16410156,2410
4004,FA1,4,16408611,16410151,1540
4005,CHI,0,16410301,16411411,1110
4006,FA1,1,16410951,16412561,1610
4007,CHI,0,16411426,16412576,1150
4008,FA1,1,16412931,16413221,290
4009,FA1,1,16414406,16414716,310
4010,CHI,0,16415531,16415861,330
4011,FA1,1,16416006,16416416,410
4012,FA1,1,16417931,16418721,790
4013,FA1,1,16419906,16420266,360
4014,CHI,0,16420266,16420786,520
4015,FA1,1,16420786,16421326,540
4016,FA1,10,16422796,16425516,2720
4017,FA1,1,16425756,16426036,280
4018,FA1,7,16426876,16428386,1510
4019,FA1,10,16435291,16437491,2200
4020,CHI,0,16437561,16438271,710
4021,FA1,13,16438766,16440606,1840
4022,FA1,6,16441846,16443056,1210
4023,CHI,0,16445171,16446001,830
4024,FA1,1,16446416,16446956,540
4025,FA1,1,16449056,16449876,820
4026,FA1,9,16451176,16453936,2760
4027,CHI,0,16452606,16453546,940
4028,FA1,4,16455606,16457576,1970
4029,CHI,0,16458001,16458341,340
4030,FA1,1,16458711,16459461,750
4031,FA1,4,16460696,16463036,2340
4032,CHI,0,16465151,16465971,820
4033,FA1,1,16466341,16467171,830
4034,FA1,4,16468661,16470891,2230
4035,CHI,0,16472466,16472966,500
4036,FA1,3,16473246,16474606,1360
4037,CHI,0,16476036,16476516,480
4038,FA1,4,16477166,16478046,880
4039,FA1,4,16478976,16479996,1020
4040,CHI,0,16479436,16480576,1140
4041,FA1,1,16480776,16481806,1030
4042,CHI,0,16481511,16482441,930
4043,FA1,1,16482866,16483536,670
4044,CHI,0,16484031,16485221,1190
4045,CHI,0,16485596,16486196,600
4046,CHI,0,16487936,16489226,1290
4047,FA1,1,16489511,16490251,740
4048,FA1,2,16491241,16492331,1090
4049,CHI,0,16492256,16492826,570
4050,FA1,2,16492981,16493641,660
4051,CHI,0,16495040,16495680,640
4052,FA1,1,16496540,16496850,310
4053,FA1,1,16498105,16498985,880
4054,FA1,1,16500525,16501645,1120
4055,FA1,1,16502195,16502365,170
4056,FA1,3,16504190,16505220,1030
4057,FA1,4,16506815,16508185,1370
4058,CHI,0,16508475,16509295,820
4059,CHI,0,16509695,16510055,360
4060,CHI,0,16510345,16512025,1680
4061,CHI,0,16512435,16513465,1030
4062,CHI,0,16514130,16514970,840
4063,FA1,8,16515630,16520280,4650
4064,CHI,0,16518955,16520265,1310
4065,CHI,0,16520405,16521265,860
4066,FA1,15,16520980,16528620,7640
4067,CHI,0,16521325,16522285,960
4068,CHI,0,16523730,16524190,460
4069,CHI,0,16525770,16526480,710
4070,FA1,1,16530180,16530520,340
4071,CHI,0,16531105,16531965,860
4072,FA1,13,16531120,16534250,3130
4073,CHI,0,16531985,16532685,700
4074,CHI,0,16536685,16537535,850
4075,FA1,7,16537920,16541750,3830
4076,CHI,0,16538805,16539475,670
4077,CHI,0,16540020,16540670,650
4078,CHI,0,16542475,16543285,810
4079,FA1,15,16542485,16550335,7850
4080,CHI,0,16543790,16544910,1120
4081,CHI,0,16545200,16546560,1360
4082,CHI,0,16548540,16549440,900
4083,FA1,1,16551120,16553980,2860
4084,FA1,3,16554110,16554990,880
4085,FA1,1,16555765,16557845,2080
4086,CHI,0,16557120,16557850,730
4087,CHI,0,16557965,16558465,500
4088,FA1,10,16559225,16562585,3360
4089,CHI,0,16563085,16564045,960
4090,FA1,1,16564355,16564565,210
4091,FA1,3,16565110,16565720,610
4092,FA1,0,16568945,16569325,380
4093,CHI,0,16569785,16570185,400
4094,FA1,1,16570815,16571455,640
4095,FA1,10,16572115,16575055,2940
4096,CHI,0,16572805,16573255,450
4097,CHI,0,16579180,16580190,1010
4098,FA1,1,16580495,16580935,440
4099,FA1,11,16581935,16584955,3020
4100,FA1,2,16585875,16586675,800
4101,FA1,2,16588205,16588635,430
4102,FA1,12,16589320,16592110,2790
4103,FC1,4,16591655,16592935,1280
4104,FA1,4,16593405,16594575,1170
4105,FC1,4,16594290,16595360,1070
4106,FA1,4,16595375,16596635,1260
4107,FA1,13,16597095,16600535,3440
4108,FC1,5,16601055,16602585,1530
4109,FA1,6,16602900,16604490,1590
4110,FA1,1,16605175,16606375,1200
4111,FA1,6,16613735,16614535,800
4112,FA1,12,16615525,16619185,3660
4113,FC1,5,16621505,16623475,1970
4114,FA1,10,16624460,16626940,2480
4115,FC1,4,16627140,16629310,2170
4116,FA1,9,16629455,16632125,2670
4117,FA1,7,16633460,16634630,1170
4118,FA1,4,16636715,16637355,640
4119,FC1,1,16637845,16638295,450
4120,FA1,5,16641870,16642890,1020
4121,FA1,3,16644070,16645110,1040
4122,FA1,6,16645470,16646330,860
4123,FA1,13,16652165,16654425,2260
4124,FC1,1,16656205,16656625,420
4125,FA1,3,16657185,16658095,910
4126,FC1,1,16658270,16658720,450
4127,FA1,10,16660745,16663285,2540
4128,FC1,7,16664635,16668865,4230
4129,CHI,0,16665170,16666380,1210
4130,CHI,0,16666790,16667770,980
4131,FA1,3,16668375,16669485,1110
4132,CHI,0,16676770,16677120,350
4133,CHI,0,16677285,16677655,370
4134,FA1,1,16678855,16679435,580
4135,FC1,2,16679745,16680685,940
4136,FA1,2,16681355,16681765,410
4137,FA1,1,16682190,16682450,260
4138,FA1,9,16686240,16687450,1210
4139,FA1,3,16688615,16689735,1120
4140,FC1,6,16691405,16692605,1200
4141,FA1,5,16693225,16694925,1700
4142,FC1,8,16695165,16697155,1990
4143,FC1,8,16698370,16701140,2770
4144,FA1,8,16700875,16702945,2070
4145,FA1,7,16705400,16706360,960
4146,FA1,5,16707040,16707840,800
4147,FA1,1,16711770,16712140,370
4148,FA1,1,16715695,16716215,520
4149,FA1,4,16716725,16717735,1010
4150,FA1,1,16718300,16719000,700
4151,FA1,19,16719010,16722140,3130
4152,FC1,6,16722695,16723875,1180
4153,FA1,4,16723925,16725345,1420
4154,FC1,4,16725375,16726015,640
4155,FA1,3,16726325,16728185,1860
4156,FC1,6,16730736,16733086,2350
4157,FA1,8,16739925,16742197,2272
4158,CHI,0,16741815,16742208,393
4159,FA1,1,16743095,16743518,423
4160,FA1,1,16745154,16745461,307
4161,FA1,11,16746222,16748337,2115
4162,FA1,7,16749379,16750642,1263
4163,FC1,6,16751004,16753276,2272
4164,CHI,0,16751902,16753052,1150
4165,FA1,5,16753931,16755610,1679
4166,FC1,4,16756541,16757343,802
4167,FC1,1,16761000,16761346,346
4168,FC1,0,16763032,16763904,872
4169,FA1,22,16766149,16771268,5119
4170,FA1,7,16771499,16773714,2215
4171,FA1,7,16776431,16778523,2092
4172,FC1,3,16778512,16781754,3242
4173,FA1,5,16781611,16782997,1386
4174,FA1,5,16784402,16786320,1918
4175,FA1,1,16787402,16787868,466
4176,FA1,21,16788922,16793837,4915
4177,FC1,8,16793230,16796000,2770
4178,FA1,1,16794814,16795280,466
4179,FA1,5,16796032,16797000,968
4180,FA1,13,16797057,16799221,2164
4181,FC1,1,16799570,16799881,311
4182,FA1,7,16799853,16801903,2050
4183,FC1,3,16800725,16801709,984
4184,FA1,6,16802056,16803778,1722
4185,FA1,1,16809802,16810434,632
4186,FC1,0,16812290,16813474,1184
4187,FA1,2,16814458,16815072,614
4188,FA1,7,16816290,16818362,2072
4189,FA1,8,16818485,16820540,2055
4190,FA1,12,16822844,16824872,2028
4191,FA1,7,16826702,16828252,1550
4192,FA1,7,16828563,16830550,1987
4193,FA1,5,16833183,16834496,1313
4194,FA1,0,16834894,16835380,486
4195,FC1,3,16834914,16837126,2212
4196,FA1,2,16838285,16838696,411
4197,FA1,5,16838966,16840702,1736
4198,FC1,4,16840092,16842272,2180
4199,FA1,1,16842587,16843799,1212
4200,FC1,2,16844339,16845100,761
4201,FA1,2,16845262,16846302,1040
4202,FC1,3,16846517,16851216,4699
4203,FA1,2,16851922,16852426,504
4204,FA1,4,16868621,16869888,1267
4205,FA1,1,16870949,16871330,381
4206,CHI,0,16903118,16903554,436
4207,FA1,1,16903771,16904286,515
4208,FA1,4,16911218,16912278,1060
4209,CHI,0,16913902,16914408,506
4210,FA1,1,16914521,16914789,268
4211,CHI,0,16916668,16917278,610
4212,FA1,1,16917872,16918000,128
4213,FA1,1,16918668,16918975,307
4214,FA1,6,16920336,16921177,841
4215,CHI,0,16921686,16922122,436
4216,FA1,1,16922382,16922836,454
4217,CHI,0,16924686,16925320,634
4218,FA1,6,16925349,16928694,3345
4219,CHI,0,16927220,16928151,931
4220,FA1,2,16928998,16929576,578
4221,CHI,0,16930134,16935246,5112
4222,FA1,8,16931288,16934030,2742
4223,FA1,4,16934282,16935381,1099
4224,FC1,1,16935426,16935831,405
4225,FA1,1,16936157,16936435,278
4226,FA1,4,16939754,16940804,1050
4227,FA1,7,16942586,16943798,1212
4228,FA1,15,16945750,16948064,2314
4229,FA1,6,17021967,17024999,3032
4230,CHI,0,17022837,17024614,1777
4231,CHI,0,17026659,17027175,516
4232,FA1,3,17027981,17028981,1000
4233,FA1,9,17029577,17031936,2359
4234,FA1,5,17032111,17033302,1191
4235,FA1,3,17033685,17033990,305
4236,CHI,0,17034724,17035362,638
4237,FA1,3,17035618,17036518,900
4238,CHI,0,17037089,17037550,461
4239,FA1,14,17037865,17040745,2880
4240,CHI,0,17041359,17042035,676
4241,FA1,1,17042445,17042994,549
4242,FA1,6,17043134,17045332,2198
4243,CHI,0,17044080,17045260,1180
4244,CHI,0,17045670,17046661,991
4245,FA1,1,17045706,17046282,576
4246,FA1,8,17046940,17049751,2811
4247,CHI,0,17048579,17049687,1108
4248,CHI,0,17051543,17052624,1081
4249,FA1,8,17086962,17088800,1838
4250,FA1,4,17090375,17091444,1069
4251,FA1,10,17094000,17096349,2349
4252,CHI,0,17096952,17097866,914
4253,FA1,7,17097397,17098950,1553
4254,CHI,0,17098872,17099663,791
4255,FA1,2,17109850,17110616,766
4256,FA1,18,17110784,17114850,4066
4257,FA1,2,17114925,17116172,1247
4258,FA1,7,17117400,17119326,1926
4259,CHI,0,17121622,17122166,544
4260,FA1,1,17122376,17123092,716
4261,FC1,6,17125191,17126932,1741
4262,FA1,6,17128444,17129987,1543
4263,FA1,8,17131660,17133413,1753
4264,FA1,12,17137796,17141093,3297
4265,FA1,18,17141160,17144592,3432
4266,FA1,5,17173100,17173983,883
4267,FA1,9,17183775,17185245,1470
4268,FA1,1,17198902,17199364,462
4269,FC1,2,17199671,17200606,935
4270,FC1,2,17200759,17201429,670
4271,FA1,26,17201775,17206484,4709
4272,FC1,5,17206722,17209144,2422
4273,FA1,5,17209320,17210320,1000
4274,FA1,4,17210875,17211990,1115
4275,FC1,0,17212594,17214046,1452
4276,FC1,0,17231707,17234392,2685
4277,FA1,10,17234990,17237530,2540
4278,FC1,1,17237652,17237848,196
4279,FA1,8,17238044,17240201,2157
4280,CHI,0,17240337,17241024,687
4281,FA1,7,17241366,17243131,1765
4282,FC1,3,17246568,17247392,824
4283,FA1,6,17247941,17249470,1529
4284,FA1,8,17252528,17254274,1746
4285,CHI,0,17265138,17266658,1520
4286,CHI,0,17268530,17268902,372
4287,FA1,6,17269136,17270273,1137
4288,CHI,0,17271625,17272096,471
4289,FA1,5,17272294,17273353,1059
4290,CHI,0,17275100,17276232,1132
4291,FA1,14,17276863,17279236,2373
4292,CHI,0,17279206,17279912,706
4293,FA1,1,17280000,17280588,588
4294,CHI,0,17280647,17280980,333
4295,CHI,0,17281724,17282018,294
4296,FA1,6,17282235,17283549,1314
4297,FA1,3,17289059,17289589,530
4298,FA1,7,17297961,17299412,1451
4299,FA1,11,17300608,17303764,3156
4300,CHI,0,17370380,17371423,1043
4301,FA1,6,17371268,17372436,1168
4302,FA1,5,17373289,17374190,901
4303,FA1,1,17375077,17375401,324
4304,FA1,4,17375627,17378091,2464
4305,FA1,4,17379071,17380648,1577
4306,FA1,4,17382169,17383240,1071
4307,CHI,0,17383648,17383845,197
4308,FA1,12,17384788,17388056,3268
4309,FC1,0,17454038,17455236,1198
4310,FC1,0,17463104,17465215,2111
4311,FC1,1,17466190,17467387,1197
4312,FC1,4,17471060,17473517,2457
4313,FA1,1,17479580,17480248,668
4314,FC1,0,17480278,17482656,2378
4315,FC1,1,17485196,17485801,605
4316,FC1,2,17486881,17489202,2321
4317,FA1,18,17513053,17518004,4951
4318,CHI,0,17514860,17515540,680
4319,FC1,0,17518757,17519594,837
4320,FA1,5,17521224,17522257,1033
4321,FC1,2,17522297,17523314,1017
4322,FA1,5,17523215,17524412,1197
4323,FC1,4,17524321,17525321,1000
4324,FA1,5,17526346,17528034,1688
4325,FA1,10,17528503,17530860,2357
4326,FA1,10,17534850,17536245,1395
4327,FC1,2,17536237,17537392,1155
4328,FA1,7,17538024,17539790,1766
4329,FA1,21,17542584,17547546,4962
4330,FA1,5,17549369,17550389,1020
4331,FC1,1,17550819,17552664,1845
4332,FA1,7,17552724,17553872,1148
4333,FC1,1,17554436,17554654,218
4334,FA1,20,17555661,17560471,4810
4335,FA1,11,17561733,17564724,2991
4336,FC1,1,17568550,17569055,505
4337,FC1,0,17570643,17571892,1249
4338,FA1,1,17572262,17572599,337
4339,FA1,1,17574060,17574440,380
4340,FA1,7,17574812,17576614,1802
4341,FC1,5,17575693,17578218,2525
4342,FA1,5,17578598,17579935,1337
4343,FC1,0,17584305,17587731,3426
4344,FA1,10,17595265,17597344,2079
4345,FC1,0,17595374,17595704,330
4346,FC1,0,17596814,17597704,890
4347,FA1,12,17597611,17599918,2307
4348,FC1,0,17599155,17599925,770
4349,FA1,9,17600189,17601942,1753
4350,FC1,0,17601975,17602470,495
4351,FA1,14,17602461,17604401,1940
4352,FC1,1,17605459,17606350,891
4353,CHI,0,17626534,17628204,1670
4354,FA1,1,17628199,17628339,140
4355,FA1,2,17629339,17630139,800
4356,FA1,7,17630709,17632469,1760
4357,FA1,6,17634679,17636439,1760
4358,CHI,0,17636569,17637029,460
4359,FA1,4,17638249,17639339,1090
4360,FA1,4,17641774,17642594,820
4361,FA1,3,17645034,17646414,1380
4362,CHI,0,17645794,17646414,620
4363,FA1,3,17647194,17648894,1700
4364,CHI,0,17647194,17648894,1700
4365,FA1,12,17649964,17651744,1780
4366,CHI,0,17650434,17651014,580
4367,CHI,0,17651904,17652524,620
4368,CHI,0,17653974,17655074,1100
4369,CHI,0,17655274,17655854,580
4370,FA1,9,17657274,17659984,2710
4371,FC1,2,17660924,17661404,480
4372,FA1,6,17661579,17664229,2650
4373,CHI,0,17662094,17663494,1400
4374,FA1,17,17665924,17670224,4300
4375,FC1,0,17673264,17676514,3250
4376,FA1,12,17677334,17680614,3280
4377,CHI,0,17680004,17680614,610
4378,FC1,0,17680859,17682039,1180
4379,CHI,0,17682309,17682689,380
4380,FA1,13,17682719,17685989,3270
4381,CHI,0,17683424,17683884,460
4382,CHI,0,17684484,17684984,500
4383,FC1,6,17685264,17687324,2060
4384,FA1,6,17687734,17689114,1380
4385,FC1,4,17689534,17690524,990
4386,FA1,3,17691189,17692069,880
4387,FA1,17,17692759,17696199,3440
4388,FC1,16,17692769,17699559,6790
4389,FA1,7,17700444,17703994,3550
4390,FA1,9,17704209,17706559,2350
4391,FC1,0,17708624,17709964,1340
4392,FA1,2,17710194,17711284,1090
4393,FA1,8,17711789,17713469,1680
4394,FA1,3,17714209,17714909,700
4395,FA1,8,17715549,17718419,2870
4396,FC1,0,17719019,17720299,1280
4397,CHI,0,17721669,17722649,980
4398,FC1,1,17723239,17723929,690
4399,FA1,7,17726434,17727224,790
4400,FA1,3,17732139,17732859,720
4401,FA1,2,17734119,17734799,680
4402,FA1,2,17735969,17736699,730
4403,FA1,3,17737504,17738764,1260
4404,FC1,0,17742904,17745204,2300
4405,FA1,2,17743564,17744584,1020
4406,FA1,12,17745614,17749004,3390
4407,FA1,13,17750019,17752119,2100
4408,CHI,0,17752829,17753429,600
4409,CHI,0,17753509,17756539,3030
4410,FC1,5,17755734,17757204,1470
4411,FA1,3,17756409,17757299,890
4412,FC1,0,17757794,17762714,4920
4413,FA1,10,17764112,17767102,2990
4414,FC1,0,17767397,17768287,890
4415,FA1,3,17768820,17769850,1030
4416,FC1,5,17770345,17772055,1710
4417,FA1,6,17772730,17773660,930
4418,FA1,6,17774165,17776005,1840
4419,FC1,3,17774705,17776005,1300
4420,FA1,5,17777895,17778995,1100
4421,FA1,2,17779765,17780215,450
4422,FC1,5,17781520,17789830,8310
4423,FA1,7,17790885,17792085,1200
4424,FA1,7,17793985,17796045,2060
4425,FC1,3,17797205,17797785,580
4426,FA1,3,17797955,17798525,570
4427,CHI,0,17800065,17804765,4700
4428,FC1,6,17800070,17804000,3930
4429,FA1,7,17803120,17804760,1640
4430,FA1,1,17805795,17807035,1240
4431,FC1,5,17808135,17810605,2470
4432,FA1,15,17811270,17814740,3470
4433,FA1,1,17815225,17815445,220
4434,FC1,6,17815615,17818465,2850
4435,FA1,19,17818895,17822395,3500
4436,FA1,15,17823030,17826350,3320
4437,CHI,0,17826740,17826970,230
4438,FA1,2,17827835,17828175,340
4439,CHI,0,17828955,17829425,470
4440,CHI,0,17830230,17830740,510
4441,FA1,2,17830485,17832495,2010
4442,CHI,0,17832935,17833325,390
4443,FA1,6,17833270,17835320,2050
4444,CHI,0,17835820,17836130,310
4445,CHI,0,17838210,17838420,210
4446,CHI,0,17839520,17840080,560
4447,FA1,10,17840200,17842600,2400
4448,FA1,5,17843120,17845220,2100
4449,FA1,1,17854440,17855030,590
4450,FA1,4,17856815,17858245,1430
4451,FC1,6,17859760,17861660,1900
4452,FA1,7,17861440,17862300,860
4453,CHI,0,17862790,17869130,6340
4454,FA1,18,17863495,17866605,3110
4455,FA1,6,17867520,17869090,1570
4456,FA1,5,17869705,17871105,1400
4457,FA1,4,17871965,17873315,1350
4458,CHI,0,17874375,17876565,2190
4459,FC1,5,17875000,17876810,1810
4460,FA1,3,17877160,17878350,1190
4461,FC1,10,17878465,17882245,3780
4462,FA1,9,17883485,17885855,2370
4463,FC1,8,17887120,17889490,2370
4464,FA1,4,17889935,17891245,1310
4465,FA1,18,17892440,17896170,3730
4466,FC1,7,17900985,17904065,3080
4467,FA1,10,17904295,17908455,4160
4468,FC1,2,17908475,17909375,900
4469,FA1,7,17909355,17911065,1710
4470,CHI,0,17911230,17913510,2280
4471,FA1,11,17911830,17913520,1690
4472,FA1,2,17914185,17914925,740
4473,FA1,4,17915215,17916245,1030
4474,FC1,1,17915530,17915830,300
4475,FC1,1,17917470,17917840,370
4476,FC1,2,17920135,17920435,300
4477,FA1,0,17920575,17920855,280
4478,FA1,3,17922825,17923845,1020
4479,FC1,1,17926105,17926305,200
4480,FA1,6,17927195,17928695,1500
4481,FA1,6,17929675,17930885,1210
4482,FC1,4,17932550,17933890,1340
4483,FA1,7,17934370,17935640,1270
4484,CHI,0,17936110,17937330,1220
4485,FA1,19,17936145,17940995,4850
4486,CHI,0,17938140,17939100,960
4487,FA1,7,17941740,17943010,1270
4488,CHI,0,17943645,17944805,1160
4489,CHI,0,17945085,17945795,710
4490,CHI,0,17946780,17949380,2600
4491,FC1,8,17948300,17951450,3150
4492,FA1,13,17952085,17955695,3610
4493,CHI,0,17954165,17955685,1520
4494,FC1,1,17955050,17955440,390
4495,FA1,3,17956485,17957085,600
4496,FC1,5,17957545,17958745,1200
4497,FA1,1,17958625,17959015,390
4498,FA1,8,17959100,17961880,2780
4499,FC1,1,17961190,17961420,230
4500,FC1,1,17962640,17966130,3490
4501,FC1,5,17967985,17969385,1400
4502,FA1,6,17969735,17971275,1540
4503,FC1,9,17972025,17975635,3610
4504,FA1,11,17975170,17977310,2140
4505,FA1,8,17977795,17979405,1610
4506,FC1,0,17978400,17980300,1900
4507,FA1,4,17980880,17981670,790
4508,FC1,0,17981895,17986965,5070
4509,FC1,0,17989570,17993750,4180
4510,FA1,0,17995140,17997190,2050
4511,FC1,0,17996945,18005755,8810
4512,FC1,12,18007285,18011915,4630
4513,FA1,1,18008780,18009160,380
4514,FA1,9,18012030,18013570,1540
4515,FC1,3,18014230,18015880,1650
4516,FA1,7,18015840,18017390,1550
4517,FC1,5,18017625,18019385,1760
4518,FA1,7,18019235,18020875,1640
4519,FA1,5,18040365,18041535,1170
4520,FC1,1,18045390,18046280,890
4521,FA1,5,18046005,18047355,1350
4522,FC1,4,18047420,18048610,1190
4523,CHI,0,18054225,18055075,850
4524,CHI,0,18057540,18058110,570
4525,CHI,0,18060445,18070175,9730
4526,FC1,1,18066770,18067480,710
4527,FA1,2,18067695,18068015,320
4528,FC1,3,18068105,18069395,1290
4529,FC1,3,18070670,18071790,1120
4530,FA1,6,18071580,18072580,1000
4531,FA1,5,18074046,18075286,1240
4532,FC1,4,18075700,18076690,990
4533,FC1,2,18077826,18080446,2620
4534,FA1,1,18095066,18095916,850
4535,FA1,8,18100131,18102581,2450
4536,FC1,1,18101876,18102516,640
4537,FC1,1,18104456,18104806,350
4538,FC1,7,18108421,18109271,850
4539,FA1,12,18111006,18112996,1990
4540,FC1,1,18113421,18113841,420
4541,FC1,5,18115661,18117291,1630
4542,FA1,4,18117246,18118076,830
4543,FC1,15,18117690,18122560,4870
4544,FA1,1,18122405,18123115,710
4545,FC1,6,18122985,18124865,1880
4546,FA1,1,18124950,18125360,410
4547,FC1,7,18125425,18128645,3220
4548,FA1,7,18129135,18130915,1780
4549,CHI,0,18130975,18131405,430
4550,FA1,5,18132790,18134150,1360
4551,CHI,0,18133620,18134160,540
4552,FC1,3,18134440,18135650,1210
4553,FA1,12,18136355,18139155,2800
4554,FC1,1,18139295,18139975,680
4555,FC1,8,18141355,18143805,2450
4556,FA1,2,18144310,18145100,790
4557,FC1,1,18145125,18145645,520
4558,FA1,14,18145735,18149515,3780
4559,FA1,15,18150095,18154265,4170
4560,FA1,4,18154290,18155120,830
4561,CHI,0,18155125,18155805,680
4562,FC1,3,18158475,18161875,3400
4563,FA1,1,18161345,18161895,550
4564,FA1,4,18174500,18176290,1790
4565,FC1,1,18178565,18178975,410
4566,FA1,1,18179290,18179780,490
4567,FC1,27,18182445,18208325,25880
4568,FA1,8,18208525,18211735,3210
4569,FC1,5,18211920,18215670,3750
4570,FC1,0,18215795,18219755,3960
4571,FA1,6,18219435,18223615,4180
4572,FC1,3,18223645,18228955,5310
4573,FA1,9,18229700,18232000,2300
4574,FA1,37,18233465,18243615,10150
4575,FC1,1,18241130,18241610,480
4576,FC1,7,18244640,18246520,1880
4577,FC1,8,18248620,18250870,2250
4578,FC1,2,18251815,18252745,930
4579,FA1,30,18253720,18260540,6820
4580,FC1,6,18264980,18267810,2830
4581,FA1,1,18267705,18268235,530
4582,FC1,1,18268450,18268990,540
4583,FA1,2,18269240,18270570,1330
4584,FA1,2,18270625,18271875,1250
4585,FC1,8,18271510,18275760,4250
4586,FA1,0,18272070,18274010,1940
4587,FA1,4,18275530,18276780,1250
4588,FC1,1,18276765,18277265,500
4589,FA1,9,18277195,18279405,2210
4590,FC1,1,18280310,18280910,600
4591,FA1,7,18280920,18282480,1560
4592,CHI,0,18282040,18282540,500
4593,CHI,0,18283090,18283540,450
4594,FA1,4,18283965,18285185,1220
4595,CHI,1,18285385,18286055,670
4596,FC1,1,18286660,18287070,410
4597,FA1,2,18287555,18288595,1040
4598,FC1,7,18290710,18294680,3970
4599,FA1,3,18294485,18295775,1290
4600,CHI,0,18295160,18295610,450
4601,FC1,4,18297365,18299885,2520
4602,CHI,0,18299345,18299865,520
4603,FC1,1,18300855,18301295,440
4604,FA1,27,18301355,18306725,5370
4605,CHI,0,18302980,18303650,670
4606,FC1,1,18307015,18307735,720
4607,FA1,15,18307725,18310795,3070
4608,CHI,0,18309410,18309960,550
4609,FA1,7,18311085,18312365,1280
4610,FC1,1,18312255,18312795,540
4611,FA1,2,18313145,18314105,960
4612,FC1,8,18314225,18316325,2100
4613,FA1,13,18316445,18318875,2430
4614,FC1,12,18319200,18322960,3760
4615,FA1,6,18323630,18325670,2040
4616,CHI,0,18323850,18324110,260
4617,CHI,0,18325640,18326090,450
4618,FC1,5,18326135,18327795,1660
4619,FA1,12,18327995,18330545,2550
4620,FC1,1,18330360,18330800,440
4621,FA1,5,18331780,18333190,1410
4622,CHI,0,18335085,18335845,760
4623,CHI,0,18342815,18343285,470
4624,CHI,0,18350300,18350900,600
4625,FA1,6,18357390,18361030,3640
4626,FC1,1,18361550,18362190,640
4627,FA1,1,18362750,18363210,460
4628,FC1,2,18363540,18365890,2350
4629,FA1,7,18365885,18368695,2810
4630,FC1,4,18370200,18372610,2410
4631,FA1,14,18372165,18377285,5120
4632,FC1,1,18377865,18378675,810
4633,CHI,0,18380620,18380980,360
4634,CHI,0,18383320,18383580,260
4635,CHI,0,18384300,18384770,470
4636,FA1,4,18384820,18385620,800
4637,FC1,1,18385650,18386210,560
4638,FA1,8,18386730,18389110,2380
4639,FC1,3,18390960,18391820,860
4640,FA1,1,18392280,18392870,590
4641,FA1,12,18394155,18402585,8430
4642,FC1,3,18402090,18403560,1470
4643,FA1,1,18403525,18404665,1140
4644,FA1,7,18407225,18409635,2410
4645,CHI,0,18412350,18449980,37630
4646,FC1,6,18413585,18416695,3110
4647,FA1,14,18416250,18419760,3510
4648,FA1,0,18432410,18434700,2290
4649,FC1,4,18439485,18440865,1380
4650,FA1,2,18442965,18445615,2650
4651,CHI,0,18452810,18453310,500
4652,CHI,0,18455650,18456830,1180
4653,FC1,7,18461020,18463490,2470
4654,FA1,10,18464035,18466515,2480
4655,FC1,1,18467365,18467935,570
4656,FA1,6,18468800,18470140,1340
4657,CHI,0,18479640,18480520,880
4658,CHI,0,18481390,18482190,800
4659,FA1,6,18491020,18492930,1910
4660,FC1,4,18496985,18499715,2730
4661,FC1,3,18500000,18502240,2240
4662,FC1,3,18502885,18503865,980
4663,CHI,0,18503790,18505440,1650
4664,FA1,40,18505515,18517995,12480
4665,CHI,0,18516655,18517085,430
4666,FC1,14,18528860,18534320,5460
4667,FA1,12,18534390,18538990,4600
4668,FC1,8,18545680,18548990,3310
4669,FA1,8,18548475,18552055,3580
4670,FA1,5,18559295,18561785,2490
4671,CHI,0,18562570,18568540,5970
4672,FC1,4,18563480,18564910,1430
4673,FA1,22,18565395,18572845,7450
4674,CHI,0,18569985,18570675,690
4675,CHI,0,18572780,18573660,880
4676,FC1,1,18573290,18574140,850
4677,FA1,14,18574405,18577875,3470
4678,CHI,0,18576400,18577370,970
4679,FA1,0,18578050,18579770,1720
4680,CHI,0,18578240,18598320,20080
4681,FC1,1,18580505,18583035,2530
4682,FC1,4,18599320,18601310,1990
4683,FA1,8,18601565,18603745,2180
4684,FA1,4,18604795,18606205,1410
4685,FC1,5,18607750,18609320,1570
4686,FA1,6,18609285,18610575,1290
4687,CHI,0,18612260,18619090,6830
4688,FA1,12,18613675,18620295,6620
4689,FC1,1,18620655,18621455,800
4690,FA1,7,18621905,18624145,2240
4691,FA1,3,18624425,18625695,1270
4692,FC1,1,18626320,18627230,910
4693,FA1,3,18628815,18631005,2190
4694,FC1,6,18636780,18640940,4160
4695,FA1,1,18640920,18641550,630
4696,FA1,5,18643325,18644955,1630
4697,FC1,7,18645320,18647680,2360
4698,FA1,4,18647070,18648690,1620
4699,CHI,0,18648710,18651420,2710
4700,FA1,8,18651955,18654615,2660
4701,CHI,0,18656005,18656835,830
4702,FA1,6,18656360,18658590,2230
4703,FA1,6,18658855,18660945,2090
4704,FC1,5,18660940,18663190,2250
4705,FA1,7,18662685,18663985,1300
4706,CHI,0,18663475,18664905,1430
4707,FA1,8,18664600,18666180,1580
4708,FC1,3,18666370,18667420,1050
4709,FA1,9,18667515,18669575,2060
4710,CHI,0,18668255,18672265,4010
4711,FC1,5,18673840,18675990,2150
4712,CHI,0,18674235,18675115,880
4713,FA1,3,18676035,18677845,1810
4714,CHI,0,18677570,18678820,1250
4715,CHI,0,18679605,18680525,920
4716,CHI,0,18683445,18685795,2350
4717,FA1,5,18686100,18689690,3590
4718,CHI,0,18686495,18690505,4010
4719,FA1,7,18689920,18691970,2050
4720,FC1,4,18692040,18693660,1620
4721,FA1,4,18693735,18694805,1070
4722,FC1,5,18694840,18696120,1280
4723,FA1,8,18696130,18698680,2550
4724,FC1,2,18698645,18699565,920
4725,FA1,12,18699345,18701515,2170
4726,FC1,8,18702110,18706150,4040
4727,FA1,1,18705340,18706720,1380
4728,FC1,3,18706710,18708650,1940
4729,FA1,6,18708110,18709290,1180
4730,FC1,1,18709340,18710220,880
4731,FC1,16,18710980,18718150,7170
4732,FA1,1,18718135,18718995,860
4733,FA1,6,18732555,18734095,1540
4734,FC1,1,18734115,18734495,380
4735,CHI,0,18734445,18735595,1150
4736,FC1,2,18736590,18738050,1460
4737,FA1,3,18737990,18738880,890
4738,FC1,5,18738835,18740455,1620
4739,FA1,7,18740685,18742525,1840
4740,FC1,1,18742015,18743180,1165
4741,FC1,0,18743180,18745450,2270
4742,CHI,0,18743585,18745415,1830
4743,FC1,1,18745450,18747080,1630
4744,CHI,0,18745955,18747145,1190
4745,FA1,9,18747310,18751690,4380
4746,FA1,3,18752380,18753840,1460
4747,FC1,1,18758240,18759070,830
4748,FC1,5,18759585,18761215,1630
4749,CHI,0,18761270,18762790,1520
4750,FA1,4,18761800,18763140,1340
4751,CHI,0,18763120,18764640,1520
4752,FA1,5,18764660,18766440,1780
4753,CHI,0,18767360,18767940,580
4754,CHI,0,18769005,18769585,580
4755,FC1,0,18770030,18771200,1170
4756,CHI,0,33775008,33779178,4170
4757,FC1,2,33777983,33779163,1180
4758,FA1,13,33779803,33782423,2620
4759,CHI,0,33782143,33785373,3230
4760,FA1,0,33785408,33786438,1030
4761,FC1,2,33786433,33787053,620
4762,FA1,1,33790763,33791473,710
4763,FA1,7,33791758,33793108,1350
4764,FC1,6,33793583,33795743,2160
4765,FA1,26,33795803,33805313,9510
4766,FC1,3,33805538,33807318,1780
4767,FA1,4,33807043,33808343,1300
4768,FC1,1,33808973,33810253,1280
4769,FA1,7,33810483,33812113,1630
4770,FC1,6,33812778,33817028,4250
4771,FA1,7,33817233,33819213,1980
4772,CHI,0,33818573,33820193,1620
4773,FA1,9,33820903,33822823,1920
4774,FC1,8,33822903,33825523,2620
4775,FA1,11,33826653,33830513,3860
4776,FC1,5,33830823,33832793,1970
4777,FA1,7,33833188,33835608,2420
4778,FC1,5,33836688,33838928,2240
4779,CHI,0,33837848,33839298,1450
4780,FA1,17,33839273,33844293,5020
4781,FC1,2,33841663,33842203,540
4782,FC1,4,33844913,33846643,1730
4783,FA1,4,33846388,33847988,1600
4784,FA1,12,33849428,33852318,2890
4785,FA1,11,33852463,33856023,3560
4786,FA1,15,33857623,33862023,4400
4787,FA1,7,33863323,33865723,2400
4788,FC1,4,33868693,33870713,2020
4789,FA1,7,33870338,33871118,780
4790,FA1,2,33871158,33872118,960
4791,FC1,3,33872098,33874058,1960
4792,FA1,3,33873778,33875098,1320
4793,FC1,1,33876558,33877238,680
4794,FC1,7,33879798,33882388,2590
4795,FA1,9,33882123,33885983,3860
4796,FA1,5,33886363,33887933,1570
4797,FA1,1,33888318,33889018,700
4798,FA1,6,33890528,33892608,2080
4799,CHI,0,33894108,33894598,490
4800,FA1,3,33895483,33896553,1070
4801,FAE,7,33897648,33900718,3070
4802,FA1,8,33900836,33902736,1900
4803,FAE,0,33903446,33905646,2200
4804,FA1,20,33905406,33910636,5230
4805,FAE,0,33910901,33915271,4370
4806,FA1,8,33915326,33919606,4280
4807,CHI,0,33917196,33918646,1450
4808,FAE,3,33919261,33920211,950
4809,CHI,0,33920526,33923126,2600
4810,FA1,10,33921146,33923326,2180
4811,FC1,3,33924436,33925626,1190
4812,FA1,11,33925621,33929521,3900
4813,FC1,4,33929741,33931631,1890
4814,FA1,19,33931366,33935496,4130
4815,FC1,4,33935531,33936731,1200
4816,FA1,4,33936611,33937991,1380
4817,FC1,7,33938421,33941621,3200
4818,FAE,9,33939001,33941621,2620
4819,FA1,6,33941611,33943251,1640
4820,FA1,19,33944091,33947831,3740
4821,FC1,3,33948741,33950241,1500
4822,FA1,3,33950371,33951581,1210
4823,FC1,7,33952546,33958736,6190
4824,FC1,6,33959861,33963511,3650
4825,FA1,24,33963051,33967481,4430
4826,FA1,4,33967776,33969036,1260
4827,FC1,1,33968536,33969026,490
4828,FAE,0,33970941,33974011,3070
4829,FA1,8,33973616,33976826,3210
4830,FAE,0,33976921,33983651,6730
4831,FC1,4,33979916,33981686,1770
4832,FA1,16,33982721,33986261,3540
4833,FC1,7,33986011,33989071,3060
4834,FA1,13,33989051,33991891,2840
4835,CHI,0,33991641,33995661,4020
4836,FC1,5,33995661,33997261,1600
4837,FA1,1,33996951,33997641,690
4838,FAE,7,33998816,34000976,2160
4839,CHI,0,34000866,34001266,400
4840,CHI,0,34002636,34005116,2480
4841,FAE,5,34005126,34007406,2280
4842,CHI,0,34007446,34011436,3990
4843,FAE,3,34010961,34014851,3890
4844,CHI,0,34013486,34015646,2160
4845,FA1,8,34015676,34018466,2790
4846,CHI,0,34017371,34018981,1610
4847,FA1,1,34019926,34020546,620
4848,FAE,0,34020526,34021496,970
4849,FA1,2,34021221,34022261,1040
4850,CHI,0,34021291,34025201,3910
4851,FA1,6,34026086,34028466,2380
4852,CHI,0,34027106,34028856,1750
4853,FAE,5,34029161,34032071,2910
4854,FA1,12,34032261,34036041,3780
4855,CHI,0,34035891,34036591,700
4856,FAE,1,34036821,34040331,3510
4857,CHI,0,34038516,34039156,640
4858,CHI,0,34039446,34039996,550
4859,FA1,1,34039521,34040311,790
4860,CHI,0,34040496,34047076,6580
4861,FAE,0,34040506,34051416,10910
4862,FA1,1,34044831,34045571,740
4863,FA1,1,34050871,34051321,450
4864,FAE,9,34052476,34061766,9290
4865,CHI,0,34057521,34059361,1840
4866,FA1,10,34061651,34063701,2050
4867,FA1,12,34064256,34069906,5650
4868,CHI,0,34069296,34075786,6490
4869,FAE,0,34070041,34075071,5030
4870,FA1,8,34074596,34078036,3440
4871,FAE,0,34078536,34089416,10880
4872,FA1,2,34089556,34090256,700
4873,FA1,1,34091786,34092376,590
4874,FA1,7,34098901,34100761,1860
4875,FC1,1,34101341,34102311,970
4876,FA1,3,34102356,34103756,1400
4877,FC1,2,34103016,34104016,1000
4878,FA1,6,34103826,34105646,1820
4879,FA1,2,34105876,34106926,1050
4880,CHI,0,34112781,34113551,770
4881,FA1,5,34130316,34132146,1830
4882,CHI,0,34132201,34134081,1880
4883,CHI,0,34137141,34137871,730
4884,FC1,1,34138096,34138886,790
4885,FC1,5,34139321,34144411,5090
4886,CHI,0,34140616,34145526,4910
4887,FA1,9,34144921,34146811,1890
4888,FA1,25,34150016,34157396,7380
4889,CHI,0,34157526,34159496,1970
4890,FA1,7,34158701,34160241,1540
4891,FC1,2,34160191,34161371,1180
4892,FA1,2,34162361,34163381,1020
4893,FC1,1,34163731,34164351,620
4894,FA1,30,34165576,34172856,7280
4895,FC1,4,34175166,34177646,2480
4896,FA1,7,34177126,34178946,1820
4897,FA1,9,34178946,34181186,2240
4898,FC1,4,34181166,34182676,1510
4899,FA1,8,34182711,34185191,2480
4900,CHI,0,34188491,34189551,1060
4901,CHI,0,34194171,34195741,1570
4902,CHI,0,34196766,34200186,3420
4903,FA1,0,34210176,34211956,1780
4904,CHI,0,34211996,34220566,8570
4905,CHI,0,34223701,34225001,1300
4906,FA1,3,34229831,34231271,1440
4907,CHI,2,34231851,34232661,810
4908,CHI,0,34233146,34233936,790
4909,FA1,4,34233671,34234681,1010
4910,CHI,2,34235386,34236256,870
4911,FC1,2,34235386,34236256,870
4912,FA1,2,34236281,34237051,770
4913,FA1,11,34237446,34240626,3180
4914,FC1,1,34241356,34241806,450
4915,FA1,7,34242241,34244621,2380
4916,FC1,4,34246006,34248096,2090
4917,FA1,3,34248411,34250601,2190
4918,FC1,1,34250816,34251846,1030
4919,CHI,3,34251771,34253471,1700
4920,FA1,4,34253461,34255141,1680
4921,FC1,0,34255421,34256981,1560
4922,FA1,2,34256671,34257361,690
4923,FC1,1,34261066,34261606,540
4924,FA1,4,34262136,34264106,1970
4925,FC1,5,34263831,34266571,2740
4926,FA1,4,34266581,34268371,1790
4927,FA1,5,34268446,34269536,1090
4928,CHI,0,34277261,34277931,670
4929,FC1,0,34291766,34292616,850
4930,FA1,2,34292981,34295171,2190
4931,CHI,0,34295636,34298376,2740
4932,FC1,1,34298666,34299816,1150
4933,FA1,28,34299831,34308321,8490
4934,FC1,8,34309646,34312476,2830
4935,FA1,6,34313771,34315381,1610
4936,CHI,0,34315396,34316696,1300
4937,FC1,0,34316676,34317926,1250
4938,CHI,0,34319786,34323236,3450
4939,FA1,2,34324506,34325766,1260
4940,FA1,1,34326426,34327076,650
4941,FC1,1,34333401,34334211,810
4942,FC1,1,34346436,34347166,730
4943,FA1,3,34347301,34348991,1690
4944,FC1,6,34349036,34353896,4860
4945,FC1,9,34357686,34360896,3210
4946,FA1,9,34360921,34362561,1640
4947,FA1,6,34362721,34364921,2200
4948,FC1,3,34365251,34366971,1720
4949,FA1,9,34367131,34369121,1990
4950,FC1,7,34369536,34372156,2620
4951,FC1,7,34373746,34375536,1790
4952,FA1,1,34375531,34376201,670
4953,CHI,0,34376966,34377516,550
4954,FA1,8,34379511,34381481,1970
4955,CHI,0,34380446,34381496,1050
4956,FC1,1,34382526,34383526,1000
4957,FA1,11,34382891,34386151,3260
4958,FA1,9,34386221,34387981,1760
4959,FC1,2,34389711,34390381,670
4960,FA1,3,34390836,34391176,340
4961,FA1,3,34391466,34392526,1060
4962,CHI,0,34396516,34397106,590
4963,FC1,4,34399421,34400581,1160
4964,CHI,0,34403521,34404181,660
4965,CHI,0,34405261,34405491,230
4966,FA1,2,34405476,34406566,1090
4967,FA1,1,34406911,34407271,360
4968,CHI,0,34408201,34408481,280
4969,FA1,1,34408566,34408976,410
4970,CHI,0,34409406,34409746,340
4971,FA1,1,34409946,34410276,330
4972,CHI,0,34410621,34410911,290
4973,FA1,6,34410996,34411686,690
4974,CHI,0,34412711,34413371,660
4975,FA1,0,34414041,34414641,600
4976,CHI,0,34414971,34415751,780
4977,FA1,1,34416951,34417411,460
4978,FC1,0,34417661,34418561,900
4979,FA1,4,34418161,34421601,3440
4980,CHI,0,34419021,34419921,900
4981,CHI,0,34420381,34421201,820
4982,FA1,2,34421831,34422411,580
4983,FA1,5,34422731,34424071,1340
4984,CHI,0,34422741,34423151,410
4985,CHI,0,34429701,34430301,600
4986,FA1,0,34431491,34433751,2260
4987,FA1,0,34435111,34438101,2990
4988,FA1,0,34438296,34443116,4820
4989,FC1,0,34446526,34451456,4930
4990,FC1,0,34451761,34457121,5360
4991,FA1,3,34456881,34458361,1480
4992,CHI,0,34463061,34463731,670
4993,FC1,2,34469606,34470906,1300
4994,FA1,5,34473416,34475066,1650
4995,FC1,0,34475636,34477376,1740
4996,FA1,7,34477616,34478916,1300
4997,CHI,0,34478566,34479306,740
4998,FC1,5,34479296,34480736,1440
4999,FA1,10,34480176,34482296,2120
5000,FC1,5,34482466,34484176,1710
5001,CHI,0,34483891,34484391,500
5002,FA1,14,34484361,34487141,2780
5003,CHI,0,34485636,34485886,250
5004,FA1,7,34487411,34488601,1190
5005,CHI,0,34488021,34488531,510
5006,CHI,0,34490526,34493936,3410
5007,FC1,0,34494271,34495621,1350
5008,FA1,0,34497386,34498426,1040
5009,CHI,0,34498641,34499111,470
5010,FC1,0,34498706,34500236,1530
5011,CHI,0,34499716,34500226,510
5012,FA1,0,34500421,34501301,880
5013,FC1,6,34501451,34503441,1990
5014,CHI,0,34502881,34503081,200
5015,CHI,0,34504426,34504696,270
5016,FA1,16,34505201,34508741,3540
5017,FA1,3,34510881,34511891,1010
5018,FC1,2,34511676,34512346,670
5019,FA1,6,34512661,34514341,1680
5020,CHI,0,34514631,34514901,270
5021,FA1,1,34515881,34517241,1360
5022,CHI,0,34517776,34518566,790
5023,FA1,2,34518856,34520136,1280
5024,CHI,0,34520631,34521041,410
5025,FA1,6,34521696,34523746,2050
5026,CHI,0,34524681,34528151,3470
5027,FC1,2,34526066,34527036,970
5028,FA1,8,34527511,34529741,2230
5029,CHI,0,34530476,34531096,620
5030,FA1,4,34530516,34531626,1110
5031,FA1,1,34532281,34532461,180
5032,FA1,12,34533391,34535781,2390
5033,CHI,0,34536206,34537736,1530
5034,CHI,0,34538991,34539631,640
5035,FA1,9,34539951,34541671,1720
5036,CHI,0,34542381,34544271,1890
5037,FC1,10,34544746,34548486,3740
5038,FA1,3,34549661,34550881,1220
5039,FA1,2,34551901,34552541,640
5040,FC1,3,34552881,34553771,890
5041,FA1,3,34553971,34554901,930
5042,CHI,0,34554836,34555326,490
5043,FC1,3,34555461,34556411,950
5044,FA1,5,34556696,34557736,1040
5045,FA1,7,34557876,34559446,1570
5046,FC1,3,34559661,34560301,640
5047,FA1,6,34560341,34561311,970
5048,FC1,3,34562096,34562776,680
5049,FA1,6,34563196,34564846,1650
5050,FC1,5,34564866,34567836,2970
5051,FA1,1,34566611,34567021,410
5052,FA1,13,34569571,34572651,3080
5053,FC1,0,34576661,34578111,1450
5054,FA1,20,34578326,34582536,4210
5055,FC1,1,34583461,34584051,590
5056,FA1,3,34587216,34587716,500
5057,CHI,0,34588006,34588436,430
5058,FC1,5,34588611,34593481,4870
5059,FA1,8,34593686,34596266,2580
5060,FC1,4,34595626,34597566,1940
5061,FA1,1,34597636,34598006,370
5062,FC1,5,34600306,34602446,2140
5063,FA1,5,34602506,34603956,1450
5064,FC1,1,34603746,34604406,660
5065,FA1,1,34604596,34605016,420
5066,FC1,6,34605286,34607616,2330
5067,FA1,6,34608141,34609601,1460
5068,FC1,1,34612441,34615611,3170
5069,FA1,3,34615686,34616526,840
5070,FA1,2,34616756,34617336,580
5071,FC1,0,34619596,34620176,580
5072,FC1,0,34622266,34622806,540
5073,FC1,0,34626176,34627636,1460
5074,FA1,0,34628516,34629816,1300
5075,FC1,0,34631686,34633886,2200
5076,FA1,1,34633626,34633876,250
5077,FA1,6,34636171,34637111,940
5078,FC1,2,34637671,34638421,750
5079,FA1,8,34638736,34640506,1770
5080,FC1,0,34641881,34644691,2810
5081,FA1,0,34646396,34647876,1480
5082,CHI,0,34647501,34648131,630
5083,FA1,5,34648426,34649856,1430
5084,FA1,7,34650676,34653796,3120
5085,FA1,4,34654161,34656291,2130
5086,FA1,3,34657656,34658606,950
5087,FA1,5,34660186,34661506,1320
5088,FC1,5,34663306,34665126,1820
5089,FA1,16,34667126,34670226,3100
5090,CHI,0,34671036,34671676,640
5091,FA1,1,34671886,34672426,540
5092,CHI,0,34673066,34674256,1190
5093,FA1,1,34673791,34674221,430
5094,FA1,7,34674686,34676066,1380
5095,FC1,5,34683485,34686795,3310
5096,FA1,10,34687390,34689150,1760
5097,FC1,1,34689290,34689670,380
5098,FA1,1,34689900,34690190,290
5099,FA1,12,34694875,34698385,3510
5100,FA1,6,34699360,34701000,1640
5101,FA1,4,34702140,34703350,1210
5102,FC1,0,34703865,34705985,2120
5103,FA1,5,34704125,34705325,1200
5104,CHI,0,34705605,34706185,580
5105,FA1,5,34706195,34707295,1100
5106,CHI,0,34709475,34710275,800
5107,FA1,4,34710305,34711475,1170
5108,CHI,0,34715815,34716325,510
5109,FA1,12,34716085,34719165,3080
5110,FA1,1,34723070,34724220,1150
5111,FA1,5,34725615,34726875,1260
5112,FC1,1,34727945,34728345,400
5113,FA1,4,34734545,34736635,2090
5114,CHI,0,34734940,34735640,700
5115,FA1,4,34736970,34738530,1560
5116,FA1,2,34739650,34741020,1370
5117,FC1,2,34741075,34741745,670
5118,FA1,7,34742255,34743695,1440
5119,FA1,3,34743780,34744500,720
5120,FA1,3,34745150,34745870,720
5121,FA1,6,34746390,34747600,1210
5122,FA1,5,34748515,34749375,860
5123,FA1,10,34751465,34753575,2110
5124,FC1,1,34753720,34754330,610
5125,FA1,2,34759165,34760375,1210
5126,FC1,1,34759190,34759430,240
5127,FA1,3,34761730,34763230,1500
5128,CHI,0,34763600,34763880,280
5129,CHI,0,34764640,34764860,220
5130,FA1,9,34768820,34770730,1910
5131,FC1,0,34770755,34773175,2420
5132,CHI,0,34772425,34772685,260
5133,FA1,9,34773205,34774805,1600
5134,CHI,0,34774871,34775341,470
5135,FA1,6,34775746,34779416,3670
5136,FC1,0,34778545,34780045,1500
5137,FA1,17,34779925,34783765,3840
5138,CHI,0,34782445,34783215,770
5139,FA1,1,34783820,34784310,490
5140,FA1,5,34784675,34786115,1440
5141,CHI,0,34785735,34787015,1280
5142,FA1,6,34791995,34793365,1370
5143,FC1,0,34793365,34794125,760
5144,FA1,1,34794410,34794720,310
5145,FC1,2,34797275,34798285,1010
5146,FA1,10,34801730,34803210,1480
5147,FA1,5,34805200,34806310,1110
5148,FA1,9,34811950,34812910,960
5149,FC1,1,34813680,34814510,830
5150,FA1,7,34815045,34817635,2590
5151,FA1,10,34820680,34824530,3850
5152,FA1,11,34826745,34830625,3880
5153,FA1,1,34832425,34833755,1330
5154,FA1,20,34834830,34840100,5270
5155,FC1,5,34842955,34844995,2040
5156,FA1,7,34844995,34846215,1220
5157,CHI,0,34847425,34847605,180
5158,CHI,0,34850235,34850625,390
5159,CHI,0,34851940,34852290,350
5160,FA1,5,34855135,34855875,740
5161,FA1,3,34856005,34857065,1060
5162,CHI,0,34859305,34859685,380
5163,FA1,3,34862265,34863255,990
5164,CHI,0,34863570,34864310,740
5165,FA1,6,34864420,34865430,1010
5166,CHI,0,34868195,34868525,330
5167,FC1,0,34868870,34870610,1740
5168,CHI,0,34869850,34870300,450
5169,FA1,14,34871305,34873855,2550
5170,FC1,5,34875980,34878230,2250
5171,FA1,9,34878265,34880655,2390
5172,FC1,5,34881910,34884420,2510
5173,FA1,4,34886325,34887985,1660
5174,FC1,1,34888025,34888305,280
5175,FA1,1,34888425,34888825,400
5176,FA1,1,34889465,34889785,320
5177,FC1,8,34890525,34891475,950
5178,FA1,13,34892100,34894960,2860
5179,FC1,2,34895770,34897340,1570
5180,FA1,3,34897605,34899115,1510
5181,CHI,0,34900600,34900880,280
5182,FA1,8,34901910,34903080,1170
5183,CHI,0,34903245,34903775,530
5184,FA1,5,34905730,34906790,1060
5185,FC1,5,34906950,34909010,2060
5186,FA1,15,34909095,34912035,2940
5187,FC1,2,34911845,34912425,580
5188,FA1,12,34912545,34914415,1870
5189,FC1,1,34914860,34915350,490
5190,FA1,1,34915665,34915905,240
5191,FC1,5,34916405,34920625,4220
5192,FA1,9,34921405,34923195,1790
5193,FC1,5,34923300,34924260,960
5194,FA1,8,34924020,34925150,1130
5195,FC1,6,34926445,34929125,2680
5196,FA1,6,34929405,34930765,1360
5197,FA1,1,34931255,34931495,240
5198,FC1,8,34931485,34933775,2290
5199,FA1,3,34934430,34935150,720
5200,FC1,5,34935260,34936480,1220
5201,FA1,7,34937190,34938290,1100
5202,FC1,1,34938510,34938850,340
5203,FA1,7,34938930,34941420,2490
5204,CHI,0,34942245,34942565,320
5205,FA1,11,34943785,34945415,1630
5206,FA1,13,34947810,34950120,2310
5207,CHI,0,34954375,34954495,120
5208,FC1,1,34955695,34956375,680
5209,FA1,2,34961425,34961995,570
5210,CHI,0,34962010,34962730,720
5211,FC1,4,34962820,34963690,870
5212,CHI,0,34964005,34965445,1440
5213,FC1,8,34965705,34968715,3010
5214,FA1,7,34966320,34968220,1900
5215,CHI,0,34968280,34969520,1240
5216,FA1,11,34968990,34971140,2150
5217,FC1,0,34971160,34972430,1270
5218,CHI,0,34971865,34972415,550
5219,FA1,16,34972460,34976590,4130
5220,FC1,4,34977545,34979245,1700
5221,FA1,21,34979725,34982925,3200
5222,FA1,7,34983455,34984655,1200
5223,FA1,13,34987785,34989545,1760
5224,FC1,5,34990445,34991745,1300
5225,FA1,3,34992465,34993445,980
5226,CHI,0,34993455,34994015,560
5227,FA1,6,34994435,34995485,1050
5228,FA1,1,34995670,34995970,300
5229,CHI,0,34996300,34996920,620
5230,FC1,0,34996340,34998260,1920
5231,CHI,0,35000190,35000320,130
5232,CHI,0,35005315,35005685,370
5233,CHI,0,35005850,35006310,460
5234,CHI,0,35007560,35007870,310
5235,FC1,3,35016380,35017390,1010
5236,FA1,1,35018040,35018490,450
5237,FC1,3,35019635,35020495,860
5238,FA1,20,35020425,35023775,3350
5239,FA1,0,35024510,35026600,2090
5240,FC1,2,35026715,35027355,640
5241,FA1,4,35027745,35028525,780
5242,FA1,4,35028895,35029765,870
5243,CHI,0,35031220,35031530,310
5244,FA1,2,35041295,35041735,440
5245,CHI,0,35044525,35045215,690
5246,FA1,12,35046110,35048230,2120
5247,FA1,4,35048560,35049480,920
5248,FC1,1,35049750,35050280,530
5249,CHI,0,35051565,35051785,220
5250,CHI,0,35054325,35054575,250
5251,FC1,4,35056190,35057320,1130
5252,FA1,8,35057365,35058905,1540
5253,CHI,0,35062985,35063315,330
5254,CHI,0,35063700,35063960,260
5255,CHI,0,35065560,35066270,710
5256,FA1,10,35080350,35081800,1450
5257,FC1,3,35081965,35083615,1650
5258,FA1,6,35083240,35085290,2050
5259,FC1,0,35085965,35090245,4280
5260,CHI,0,35093225,35093985,760
5261,FA1,4,35093965,35095395,1430
5262,CHI,0,35095045,35095385,340
5263,FA1,7,35095650,35097040,1390
5264,CHI,0,35098655,35099555,900
5265,FA1,3,35099845,35100535,690
5266,CHI,0,35101450,35101950,500
5267,CHI,0,35104110,35105130,1020
5268,FA1,1,35105490,35105580,90
5269,CHI,0,35106145,35106755,610
5270,CHI,0,35107190,35107660,470
5271,CHI,0,35108795,35109345,550
5272,FA1,10,35109370,35110500,1130
5273,FC1,2,35116225,35118485,2260
5274,FA1,1,35120685,35120985,300
5275,CHI,0,35122695,35123225,530
5276,CHI,0,35123740,35124550,810
5277,CHI,0,35125255,35125715,460
5278,FA1,3,35126005,35126815,810
5279,CHI,0,35127100,35127670,570
5280,FC1,4,35127685,35128205,520
5281,CHI,0,35128185,35129115,930
5282,FC1,0,35128965,35129465,500
5283,FA1,1,35129540,35129950,410
5284,CHI,0,35129550,35130510,960
5285,CHI,0,35131020,35131840,820
5286,CHI,0,35133245,35133705,460
5287,CHI,0,35134625,35135115,490
5288,FA1,1,35135390,35135890,500
5289,CHI,0,35135860,35136840,980
5290,CHI,0,35140490,35140900,410
5291,CHI,0,35141735,35142105,370
5292,FA1,5,35142910,35143630,720
5293,CHI,0,35145450,35145920,470
5294,CHI,0,35146895,35147335,440
5295,FA1,6,35147395,35148345,950
5296,CHI,0,35150070,35151110,1040
5297,FA1,6,35151190,35152040,850
5298,FA1,2,35152195,35153265,1070
5299,FC1,1,35153770,35154340,570
5300,FA1,1,35154840,35155140,300
5301,CHI,0,35155145,35155965,820
5302,FC1,0,35155150,35158110,2960
5303,FA1,3,35157510,35159320,1810
5304,FA1,6,35160145,35161855,1710
5305,FC1,1,35162890,35163600,710
5306,FA1,11,35163895,35166125,2230
5307,FC1,2,35165600,35166140,540
5308,CHI,0,35166330,35168710,2380
5309,FA1,6,35168190,35169350,1160
5310,CHI,0,35169610,35170320,710
5311,FA1,6,35170515,35172515,2000
5312,CHI,0,35175655,35176265,610
5313,CHI,0,35182990,35183850,860
5314,CHI,0,35201830,35203030,1200
5315,FA1,1,35203410,35203650,240
5316,CHI,0,35208095,35208295,200
5317,CHI,0,35210320,35210480,160
5318,CHI,0,35210990,35211740,750
5319,FA1,1,35211915,35212395,480
5320,CHI,0,35212485,35213565,1080
5321,CHI,0,35214405,35215065,660
5322,FA1,1,35214845,35215215,370
5323,FA1,3,35215720,35216640,920
5324,FA1,1,35218520,35219180,660
5325,CHI,0,35219440,35221690,2250
5326,FA1,7,35219915,35221675,1760
5327,CHI,0,35222125,35222535,410
5328,CHI,0,35223380,35223750,370
5329,CHI,0,35224515,35224875,360
5330,FA1,1,35225045,35225305,260
5331,CHI,0,35225975,35226395,420
5332,FA1,1,35226705,35226965,260
5333,CHI,0,35227455,35227805,350
5334,FA1,6,35228590,35229270,680
5335,FA1,2,35230660,35230920,260
5336,CHI,0,35231535,35233265,1730
5337,FA1,1,35233120,35233400,280
5338,FA1,1,35234300,35234780,480
5339,FA1,2,35235890,35236300,410
5340,FA1,10,35237105,35238605,1500
5341,CHI,0,35238755,35238985,230
5342,CHI,0,35242430,35242750,320
5343,CHI,0,35249130,35249480,350
5344,FA1,11,35254195,35256955,2760
5345,FC1,1,35258085,35258935,850
5346,FC1,1,35260310,35260860,550
5347,FA1,4,35261805,35263695,1890
5348,FA1,7,35264370,35265830,1460
5349,FC1,1,35266270,35268060,1790
5350,FA1,11,35269015,35270805,1790
5351,FA1,2,35271370,35271930,560
5352,CHI,0,35272060,35272840,780
5353,CHI,0,35273590,35274110,520
5354,FA1,1,35274410,35274680,270
5355,CHI,0,35276055,35276605,550
5356,FC1,0,35285260,35286910,1650
5357,CHI,0,35286705,35287945,1240
5358,CHI,0,35288675,35289115,440
5359,CHI,0,35289715,35290545,830
5360,CHI,0,35291300,35291530,230
5361,CHI,0,35293205,35293555,350
5362,CHI,0,35295950,35296850,900
5363,FC1,1,35303050,35303830,780
5364,FA1,3,35304430,35305090,660
5365,FC1,3,35305670,35306690,1020
5366,CHI,0,35308870,35309440,570
5367,CHI,0,35310095,35311035,940
5368,FA1,1,35311435,35311785,350
5369,CHI,0,35313890,35314290,400
5370,CHI,0,35316350,35316980,630
5371,FC1,2,35317065,35318105,1040
5372,CHI,0,35318375,35319055,680
5373,CHI,0,35319715,35320045,330
5374,FA1,4,35320860,35321480,620
5375,CHI,0,35322170,35322500,330
5376,FC1,2,35322925,35323225,300
5377,FA1,5,35323695,35324345,650
5378,FC1,1,35324690,35324940,250
5379,FC1,4,35326715,35329675,2960
5380,CHI,0,35332805,35334175,1370
5381,CHI,0,35335070,35335660,590
5382,CHI,0,35340965,35341855,890
5383,CHI,0,35346850,35347110,260
5384,FA1,10,35347975,35353475,5500
5385,CHI,0,35351040,35352190,1150
5386,FA1,1,35354145,35354635,490
5387,CHI,0,35356990,35357560,570
5388,CHI,0,35361875,35362315,440
5389,CHI,0,35365355,35366815,1460
5390,FC1,5,35367085,35368615,1530
5391,FA1,4,35368830,35369360,530
5392,CHI,0,35369965,35370525,560
5393,FA1,6,35370455,35371255,800
5394,FA1,4,35373625,35374765,1140
5395,FC1,4,35375815,35377905,2090
5396,FA1,6,35378410,35380630,2220
5397,FC1,6,35380860,35382180,1320
5398,FA1,8,35382850,35384570,1720
5399,CHI,0,35385600,35386110,510
5400,CHI,0,35395925,35396995,1070
5401,FA1,1,35397400,35397680,280
5402,CHI,0,35398560,35399350,790
5403,FA1,1,35399865,35400625,760
5404,CHI,0,35400685,35401235,550
5405,FA1,14,35401500,35404660,3160
5406,CHI,0,35404990,35405100,110
5407,CHI,0,35406205,35406835,630
5408,CHI,0,35407700,35409890,2190
5409,FA1,1,35408655,35409005,350
5410,FA1,6,35410510,35411340,830
5411,CHI,0,35411405,35412295,890
5412,FA1,3,35412530,35413190,660
5413,CHI,0,35413150,35413800,650
5414,FC1,1,35413150,35413800,650
5415,FA1,1,35413985,35414415,430
5416,CHI,0,35414550,35414840,290
5417,FA1,2,35415515,35415885,370
5418,CHI,0,35416160,35416590,430
5419,CHI,0,35417195,35417645,450
5420,FC1,4,35417435,35419285,1850
5421,CHI,0,35418180,35418870,690
5422,FA1,8,35418965,35421145,2180
5423,FA1,5,35422090,35423450,1360
5424,CHI,0,35423960,35424790,830
5425,FA1,1,35425075,35425315,240
5426,CHI,0,35425645,35425935,290
5427,CHI,0,35427030,35427610,580
5428,FC1,0,35428810,35429940,1130
5429,FA1,3,35432755,35433715,960
5430,FC1,1,35433565,35433765,200
5431,FC1,3,35435715,35436545,830
5432,FA1,14,35436960,35439220,2260
5433,FC1,1,35439510,35439820,310
5434,FA1,2,35440275,35442185,1910
5435,FC1,2,35441870,35443460,1590
5436,FC1,1,35446915,35447315,400
5437,FC1,0,35448935,35450025,1090
5438,FA1,2,35451810,35452420,610
5439,CHI,0,35451810,35452440,630
5440,FC1,0,35453310,35453670,360
5441,FA1,13,35454345,35456735,2390
5442,CHI,0,35455040,35455780,740
5443,CHI,0,35456390,35456730,340
5444,CHI,0,35457430,35458690,1260
5445,FA1,1,35459220,35459470,250
5446,CHI,0,35459680,35460500,820
5447,CHI,0,35461210,35461570,360
5448,FA1,6,35462750,35463490,740
5449,FA1,3,35464740,35465160,420
5450,FC1,1,35465340,35465630,290
5451,CHI,0,35465785,35466105,320
5452,CHI,0,35466715,35467215,500
5453,FC1,7,35467795,35470815,3020
5454,CHI,0,35470035,35471165,1130
5455,FA1,1,35471850,35472130,280
5456,FA1,10,35473010,35474770,1760
5457,CHI,0,35474030,35474320,290
5458,FC1,1,35475105,35475965,860
5459,FA1,7,35477395,35478855,1460
5460,CHI,0,35480275,35480775,500
5461,FA1,1,35480805,35481075,270
5462,CHI,0,35484480,35484670,190
5463,FA1,3,35485305,35486025,720
5464,FA1,1,35487695,35488055,360
5465,CHI,0,35489975,35490445,470
5466,FA1,5,35495770,35497390,1620
5467,FC1,0,35500440,35500730,290
5468,FA1,8,35501565,35503385,1820
5469,FC1,0,35503570,35506260,2690
5470,FC1,5,35506635,35508205,1570
5471,FA1,6,35507670,35508870,1200
5472,FC1,6,35509320,35511950,2630
5473,FA1,9,35513935,35515665,1730
5474,FC1,3,35516510,35517920,1410
5475,CHI,0,35517445,35517895,450
5476,CHI,0,35518130,35518310,180
5477,FA1,3,35518320,35519000,680
5478,CHI,0,35519580,35520280,700
5479,FA1,6,35520510,35521330,820
5480,FC1,6,35521720,35523520,1800
5481,CHI,0,35525100,35525510,410
5482,CHI,0,35529805,35530105,300
5483,CHI,0,35531675,35532415,740
5484,CHI,0,35533195,35534035,840
5485,CHI,0,35534205,35534615,410
5486,CHI,0,35535160,35536930,1770
5487,FA1,12,35537095,35539125,2030
5488,FA1,5,35539250,35540290,1040
5489,CHI,0,35541330,35541730,400
5490,CHI,0,35543150,35543710,560
5491,FA1,12,35544090,35545430,1340
5492,CHI,0,35546380,35547090,710
5493,FC1,5,35546795,35547865,1070
5494,FA1,2,35549150,35549810,660
5495,CHI,0,35549610,35550860,1250
5496,FA1,1,35551125,35551635,510
5497,CHI,0,35551680,35552040,360
5498,CHI,0,35552640,35553820,1180
5499,FA1,12,35553830,35555550,1720
5500,CHI,0,35555680,35556090,410
5501,FC1,1,35557210,35559530,2320
5502,CHI,0,35557585,35558135,550
5503,CHI,0,35558540,35559390,850
5504,CHI,0,35559825,35560245,420
5505,FC1,1,35561605,35562185,580
5506,FA1,6,35562115,35563655,1540
5507,CHI,0,35563585,35563975,390
5508,FA1,4,35564520,35565450,930
5509,CHI,0,35565155,35566095,940
5510,CHI,0,35566335,35567635,1300
5511,FA1,0,35567805,35568705,900
5512,CHI,0,35571115,35573615,2500
5513,FA1,5,35572395,35573035,640
5514,FA1,2,35573685,35574215,530
5515,CHI,0,35580110,35580290,180
5516,CHI,0,35582190,35583420,1230
5517,CHI,0,35583715,35584625,910
5518,CHI,0,35584790,35585060,270
5519,FC1,0,35585675,35586265,590
5520,CHI,0,35586285,35587725,1440
5521,FC1,3,35588360,35589220,860
5522,FC1,3,35589770,35590650,880
5523,FC1,2,35591970,35592470,500
5524,FA1,10,35594200,35596290,2090
5525,FA1,13,35597870,35600550,2680
5526,CHI,0,35599610,35600530,920
5527,CHI,0,35601710,35602230,520
5528,FA1,5,35605510,35607170,1660
5529,CHI,0,35607430,35607680,250
5530,FA1,4,35610735,35611855,1120
5531,FA1,5,35612255,35613715,1460
5532,FA1,4,35615385,35616105,720
5533,CHI,0,35616985,35617535,550
5534,CHI,0,35617970,35618670,700
5535,CHI,0,35625550,35625780,230
5536,CHI,0,35626375,35626655,280
5537,CHI,0,35627415,35627805,390
5538,FA1,1,35630640,35630910,270
5539,CHI,0,35634785,35635585,800
5540,CHI,0,35635775,35637265,1490
5541,FA1,2,35637540,35638100,560
5542,CHI,0,35637760,35638580,820
5543,CHI,0,35639570,35640390,820
5544,FA1,5,35640600,35641600,1000
5545,CHI,0,35642120,35642810,690
5546,FA1,5,35643755,35645545,1790
5547,CHI,0,35645940,35646650,710
5548,FA1,5,35646725,35648215,1490
5549,CHI,0,35648230,35649300,1070
5550,FA1,2,35649565,35650305,740
5551,CHI,0,35654005,35654565,560
5552,FA1,5,35654945,35656765,1820
5553,CHI,0,35656515,35657475,960
5554,FA1,1,35657715,35657985,270
5555,CHI,0,35658880,35659220,340
5556,FA1,1,35659280,35659920,640
5557,CHI,0,35660620,35661510,890
5558,FA1,6,35661365,35662005,640
5559,CHI,0,35662175,35663145,970
5560,CHI,0,35664890,35665490,600
5561,FA1,1,35665830,35666260,430
5562,CHI,0,35666625,35667065,440
5563,CHI,0,35667685,35667835,150
5564,FA1,5,35667740,35669330,1590
5565,CHI,0,35669545,35670365,820
5566,FA1,9,35671050,35673050,2000
5567,CHI,0,35673620,35675610,1990
5568,FA1,6,35675670,35677470,1800
5569,CHI,0,35678455,35679445,990
5570,FA1,5,35679950,35680490,540
5571,CHI,0,35681020,35681790,770
5572,FA1,2,35681215,35682305,1090
5573,FC1,1,35681670,35682330,660
5574,FA1,4,35682570,35683530,960
5575,CHI,0,35683530,35684470,940
5576,CHI,0,35684730,35686490,1760
5577,FC1,0,35684730,35686480,1750
5578,CHI,0,35686815,35687635,820
5579,FC1,4,35687355,35688595,1240
5580,FA1,3,35688555,35689465,910
5581,CHI,0,35689455,35689855,400
5582,FA1,9,35690065,35691815,1750
5583,FC1,3,35690380,35692680,2300
5584,FA1,1,35692360,35692690,330
5585,FC1,0,35693195,35695185,1990
5586,CHI,0,35693540,35694270,730
5587,CHI,0,35696525,35698245,1720
5588,FA1,16,35696845,35700805,3960
5589,CHI,0,35699945,35700805,860
5590,FA1,1,35701105,35701345,240
5591,FC1,1,35701545,35701905,360
5592,CHI,0,35701945,35702715,770
5593,FA1,8,35702850,35704200,1350
5594,FC1,4,35704315,35704865,550
5595,CHI,0,35705040,35707090,2050
5596,FA1,9,35705705,35707885,2180
5597,FC1,4,35709965,35713295,3330
5598,FA1,4,35714310,35715290,980
5599,FA1,19,35716820,35720110,3290
5600,CHI,0,35726255,35726455,200
5601,FC1,7,35732215,35733815,1600
5602,FA1,3,35734595,35735195,600
5603,FA1,4,35735865,35736585,720
5604,FC1,6,35737145,35738735,1590
5605,FA1,1,35739090,35739450,360
5606,CHI,0,35753220,35753630,410
5607,CHI,0,35754175,35754555,380
5608,CHI,0,35761465,35761795,330
5609,FA1,0,35762180,35762790,610
5610,CHI,0,35763825,35764275,450
5611,FC1,1,35764770,35765140,370
5612,FC1,2,35766585,35768045,1460
5613,FA1,3,35768485,35769615,1130
5614,FC1,2,35768485,35769615,1130
5615,FA1,4,35770610,35771340,730
5616,FC1,5,35771595,35773665,2070
5617,FA1,16,35773410,35776490,3080
5618,FA1,6,35776540,35777650,1110
5619,FA1,8,35778355,35780595,2240
5620,CHI,0,35779565,35782565,3000
5621,FC1,7,35779765,35782035,2270
5622,FA1,4,35782155,35783175,1020
5623,FC1,1,35783295,35783675,380
5624,FA1,6,35784115,35785495,1380
5625,FA1,9,35785520,35787290,1770
5626,FC1,1,35791455,35791775,320
5627,FC1,7,35795245,35797295,2050
5628,FA1,1,35797990,35798380,390
5629,FC1,8,35802255,35804295,2040
5630,FA1,3,35805405,35806705,1300
5631,FC1,3,35807815,35809035,1220
5632,CHI,0,35809315,35809905,590
5633,CHI,0,35810730,35811470,740
5634,CHI,0,35811980,35812360,380
5635,FA1,1,35813400,35813930,530
5636,CHI,0,35813585,35814425,840
5637,FC1,4,35814535,35815415,880
5638,FA1,1,35815755,35816165,410
5639,FC1,3,35816450,35818500,2050
5640,CHI,0,35817405,35818505,1100
5641,FC1,7,35819075,35822445,3370
5642,CHI,0,35820450,35821510,1060
5643,CHI,0,35821750,35822270,520
5644,FA1,8,35822760,35824340,1580
5645,CHI,0,35824360,35825080,720
5646,FA1,7,35825300,35826500,1200
5647,FC1,1,35825880,35826600,720
5648,FA1,5,35826500,35827240,740
5649,FA1,5,35827690,35828450,760
5650,CHI,0,35828720,35830210,1490
5651,FA1,4,35830785,35832175,1390
5652,FA1,9,35832280,35833570,1290
5653,CHI,0,35833645,35833935,290
5654,FA1,0,35835420,35835780,360
5655,CHI,0,35835830,35836830,1000
5656,FA1,7,35837760,35838890,1130
5657,CHI,0,35839145,35839935,790
5658,CHI,0,35841380,35841790,410
5659,FA1,8,35845655,35846785,1130
5660,FC1,13,35847160,35853880,6720
5661,CHI,0,35852500,35853690,1190
5662,FA1,12,35853805,35855835,2030
5663,FC1,1,35856520,35856880,360
5664,FA1,7,35858010,35859460,1450
5665,FC1,5,35859875,35861795,1920
5666,FA1,1,35862235,35862785,550
5667,FC1,6,35862800,35863210,410
5668,FA1,4,35863535,35864415,880
5669,FC1,18,35867895,35873565,5670
5670,FA1,4,35873720,35874460,740
5671,FC1,2,35875620,35876000,380
5672,FA1,3,35876510,35877180,670
5673,FA1,6,35879485,35880715,1230
5674,CHI,0,35884540,35886880,2340
5675,FA1,0,35887120,35887520,400
5676,CHI,0,35889010,35889750,740
5677,CHI,0,35890470,35891910,1440
5678,CHI,0,35892430,35892850,420
5679,CHI,0,35893250,35893610,360
5680,FA1,0,35893810,35894860,1050
5681,CHI,0,35895045,35895545,500
5682,CHI,0,35896495,35896755,260
5683,FA1,0,35897165,35897615,450
5684,CHI,0,35898105,35899485,1380
5685,CHI,0,35902650,35903800,1150
5686,FA1,1,35904065,35905305,1240
5687,CHI,0,35906475,35907505,1030
5688,CHI,0,35907930,35908990,1060
5689,FA1,11,35908120,35910440,2320
5690,CHI,0,35910705,35911235,530
5691,FC1,2,35911560,35912350,790
5692,FA1,2,35912840,35914420,1580
5693,FC1,8,35916190,35919430,3240
5694,CHI,0,35916950,35919330,2380
5695,CHI,0,35919540,35920190,650
5696,FC1,5,35920390,35922160,1770
5697,FA1,4,35922255,35923145,890
5698,CHI,0,35929130,35929520,390
5699,CHI,0,35930975,35931645,670
5700,CHI,0,35933075,35933305,230
5701,FA1,3,35933880,35934780,900
5702,FC1,2,35934120,35934780,660
5703,FA1,8,35935340,35937640,2300
5704,FA1,6,35938750,35941260,2510
5705,FA1,8,35941825,35943365,1540
5706,FC1,1,35943655,35944025,370
5707,FA1,1,35944845,35945505,660
5708,FA1,7,35951500,35952930,1430
5709,FC1,1,35952855,35953105,250
5710,FA1,6,35953580,35954610,1030
5711,FC1,2,35954835,35956485,1650
5712,FC1,4,35957390,35958450,1060
5713,FC1,1,35961670,35962160,490
5714,FA1,1,35962695,35963175,480
5715,FC1,5,35964295,35966105,1810
5716,FA1,2,35966840,35967350,510
5717,FA1,6,35968105,35968965,860
5718,FA1,11,35970365,35972075,1710
5719,CHI,0,35972400,35972600,200
5720,FA1,0,35972760,35973670,910
5721,FC1,1,35973985,35974885,900
5722,CHI,0,35974935,35975355,420
5723,FA1,7,35975405,35976325,920
5724,FC1,1,35976555,35977515,960
5725,FA1,3,35977625,35978645,1020
5726,FC1,1,35978955,35979375,420
5727,FA1,3,35979875,35980665,790
5728,CHI,0,35980225,35980655,430
5729,FA1,4,35981225,35982525,1300
5730,FA1,3,35983475,35984495,1020
5731,FC1,4,35984235,35985645,1410
5732,FA1,11,35985475,35987305,1830
5733,FA1,13,35988700,35990570,1870
5734,FC1,1,35990885,35991145,260
5735,FC1,2,35992785,35993505,720
5736,FA1,1,35993955,35994365,410
5737,FC1,4,35995130,35996910,1780
5738,FA1,1,35996300,35996920,620
5739,CHI,0,35997140,36000530,3390
5740,FA1,7,35999015,36000475,1460
5741,FC1,1,36001015,36001795,780
5742,CHI,0,36002600,36003200,600
5743,FC1,3,36002735,36004425,1690
5744,CHI,0,36004290,36004870,580
5745,FA1,13,36005440,36008150,2710
5746,FC1,9,36012405,36014405,2000
5747,FA1,15,36015185,36017585,2400
5748,FC1,6,36018685,36020245,1560
5749,FA1,7,36020175,36021275,1100
5750,FC1,0,36022155,36023265,1110
5751,FA1,20,36023840,36027450,3610
5752,FC1,6,36027885,36029805,1920
5753,FA1,2,36030365,36031225,860
5754,FC1,3,36031475,36033105,1630
5755,FA1,18,36035700,36038750,3050
5756,CHI,0,36038015,36038725,710
5757,CHI,0,36039850,36040240,390
5758,FA1,4,36040430,36041290,860
5759,CHI,0,36041615,36042445,830
5760,FA1,1,36048550,36049540,990
5761,FA1,1,36049575,36050645,1070
5762,CHI,0,36055155,36055635,480
5763,FA1,7,36058715,36060465,1750
5764,CHI,0,36059290,36060040,750
5765,CHI,0,36061195,36062005,810
5766,FA1,4,36062160,36062820,660
5767,CHI,0,36062890,36063470,580
5768,FA1,8,36063560,36065010,1450
5769,CHI,0,36065295,36068515,3220
5770,FA1,3,36065825,36066795,970
5771,CHI,0,36070940,36072150,1210
5772,FA1,7,36071485,36073505,2020
5773,FC1,0,36072085,36072845,760
5774,CHI,0,36072715,36074085,1370
5775,CHI,0,36074380,36075230,850
5776,CHI,0,36075505,36077095,1590
5777,FC1,8,36080740,36084210,3470
5778,FA1,9,36084195,36085985,1790
5779,FC1,3,36087690,36090740,3050
5780,FA1,1,36090987,36091524,537
5781,FA1,8,36091963,36093427,1464
5782,FC1,5,36094556,36096332,1776
5783,FA1,3,36096315,36097299,984
5784,FA1,2,36097631,36098339,708
5785,FC1,5,36100568,36101819,1251
5786,FA1,1,36102127,36102579,452
5787,FA1,17,36104370,36108619,4249
5788,FA1,6,36117155,36118535,1380
5789,FC1,2,36119725,36120339,614
5790,FA1,1,36120484,36120971,487
5791,FA1,11,36131629,36134179,2550
5792,CHI,0,36136483,36136731,248
5793,CHI,0,36139967,36140401,434
5794,FA1,1,36140577,36140792,215
5795,CHI,0,36141072,36141381,309
5796,FA1,4,36142582,36143822,1240
5797,FA1,5,36143832,36144832,1000
5798,FA1,2,36146591,36146989,398
5799,CHI,0,36147697,36147995,298
5800,FA1,3,36148333,36149323,990
5801,FA1,8,36151156,36152282,1126
5802,CHI,0,36154514,36156378,1864
5803,FC1,6,36156404,36158139,1735
5804,FA1,2,36160084,36160606,522
5805,FA1,22,36160997,36164335,3338
5806,CHI,0,36169136,36169394,258
5807,FC1,4,36172740,36174183,1443
5808,FA1,13,36175196,36178615,3419
5809,FA1,6,36181619,36182839,1220
5810,FA1,5,36190035,36191331,1296
5811,CHI,0,36190054,36190414,360
5812,CHI,0,36193096,36193968,872
5813,CHI,0,36194733,36195117,384
5814,FA1,1,36195295,36195508,213
5815,CHI,0,36195927,36197226,1299
5816,FA1,1,36197450,36198236,786
5817,CHI,0,36197871,36198852,981
5818,FA1,1,36198920,36199555,635
5819,CHI,0,36199403,36200711,1308
5820,FA1,1,36200702,36201751,1049
5821,CHI,0,36201193,36201743,550
5822,CHI,0,36202390,36203371,981
5823,FA1,1,36202487,36203403,916
5824,CHI,0,36203708,36204235,527
5825,CHI,0,36204890,36208966,4076
5826,CHI,0,36210063,36210739,676
5827,FA1,1,36216541,36217569,1028
5828,FA1,9,36218852,36220483,1631
5829,CHI,0,36220788,36222131,1343
5830,CHI,0,36222525,36223525,1000
5831,FA1,1,36224887,36225327,440
5832,FA1,1,36226364,36226748,384
5833,CHI,0,36227701,36229983,2282
5834,CHI,0,36233203,36233883,680
5835,CHI,0,36234439,36235256,817
5836,FA1,1,36236519,36237187,668
5837,FA1,5,36237539,36238630,1091
5838,CHI,0,36240112,36240752,640
5839,FA1,1,36241096,36241266,170
5840,FA1,1,36241897,36242470,573
5841,CHI,0,36246503,36247252,749
5842,FA1,1,36247280,36247678,398
5843,CHI,0,36250901,36252669,1768
5844,FA1,11,36253017,36254637,1620
5845,CHI,0,36254890,36255847,957
5846,FA1,6,36255929,36257083,1154
5847,CHI,0,36258206,36258642,436
5848,CHI,0,36262191,36263354,1163
5849,FA1,1,36264023,36264169,146
5850,CHI,0,36265548,36266219,671
5851,CHI,0,36266711,36267283,572
5852,FA1,1,36267511,36267852,341
5853,CHI,0,36267747,36268479,732
5854,CHI,0,36268847,36269251,404
5855,CHI,0,36271435,36272911,1476
5856,CHI,0,36274027,36275499,1472
5857,CHI,0,36276963,36277571,608
5858,FA1,1,36278096,36278436,340
5859,CHI,0,36278431,36279499,1068
5860,CHI,0,36279975,36281235,1260
5861,CHI,0,36281863,36282315,452
5862,FA1,1,36284258,36284591,333
5863,FAE,3,36286185,36287105,920
5864,FA1,3,36287303,36287967,664
5865,FAE,6,36289015,36291305,2290
5866,FAE,2,36291590,36292310,720
5867,FA1,5,36292568,36293554,986
5868,FAE,4,36294445,36295495,1050
5869,FA1,1,36295626,36295945,319
5870,FAE,0,36297525,36301155,3630
5871,CHI,0,36298019,36298259,240
5872,FA1,42,36302527,36311935,9408
5873,CHI,0,36305678,36306518,840
5874,CHI,0,36307028,36307388,360
5875,CHI,0,36308108,36308588,480
5876,CHI,0,36309198,36310008,810
5877,FA1,36,36312489,36319967,7478
5878,CHI,0,36317483,36318023,540
5879,FAE,1,36319798,36320248,450
5880,FAE,2,36320458,36322228,1770
5881,CHI,0,36320723,36320933,210
5882,CHI,0,36322533,36322843,310
5883,FA1,40,36323804,36331387,7583
5884,CHI,0,36329495,36330095,600
5885,FAE,1,36332085,36333205,1120
5886,FA1,3,36333623,36334383,760
5887,FAE,5,36334843,36338433,3590
5888,FAE,1,36339018,36339508,490
5889,FAE,0,36340263,36343633,3370
5890,FA1,1,36343675,36344095,420
5891,FA1,4,36348368,36349616,1248
5892,FA1,23,36352116,36360067,7951
5893,FA1,5,36366917,36369463,2546
5894,FA1,10,36369700,36372980,3280
5895,FA1,1,36373315,36374074,759
5896,FA1,8,36374905,36378251,3346
5897,FA1,1,36384387,36384799,412
5898,CHI,0,36386377,36387618,1241
5899,CHI,0,36388068,36390054,1986
5900,CHI,0,36390563,36391475,912
5901,CHI,0,36391932,36393556,1624
5902,FA1,2,36392304,36393214,910
5903,CHI,0,36394522,36396615,2093
5904,FA1,3,36395227,36396139,912
5905,FC1,1,36396447,36397080,633
5906,FA1,5,36397504,36398929,1425
5907,FC1,4,36398400,36399344,944
5908,FA1,1,36399301,36399429,128
5909,FC1,2,36400794,36401326,532
5910,FA1,3,36401450,36402351,901
5911,FA1,4,36403594,36404502,908
5912,FA1,14,36405049,36407715,2666
5913,CHI,0,36407751,36408219,468
5914,FA1,1,36408691,36408939,248
5915,CHI,0,36409455,36409995,540
5916,FA1,14,36410512,36412635,2123
5917,CHI,0,36411891,36412872,981
5918,FA1,1,36412908,36413175,267
5919,FA1,6,36413559,36414924,1365
5920,CHI,0,36415131,36416913,1782
5921,FA1,5,36417162,36418630,1468
5922,CHI,0,36417756,36418636,880
5923,FA1,7,36419064,36420554,1490
5924,CHI,0,36419679,36422443,2764
5925,FA1,0,36420922,36422149,1227
5926,FA1,0,36422726,36423719,993
5927,FC1,1,36423179,36424598,1419
5928,CHI,0,36424795,36426766,1971
5929,FA1,8,36425283,36427362,2079
5930,CHI,0,36427506,36434791,7285
5931,FA1,10,36429851,36432095,2244
5932,FA1,3,36434930,36435944,1014
5933,CHI,0,36436104,36439266,3162
5934,FA1,4,36437487,36438963,1476
5935,FA1,2,36439731,36440723,992
5936,CHI,0,36439738,36444759,5021
5937,FA1,2,36441217,36442104,887
5938,FA1,11,36444898,36447891,2993
5939,CHI,0,36444898,36449182,4284
5940,CHI,0,36449259,36454067,4808
5941,FA1,8,36451195,36452431,1236
5942,FA1,2,36454355,36455114,759
5943,CHI,0,36458195,36462091,3896
5944,FA1,8,36458578,36459897,1319
5945,FA1,5,36460625,36461363,738
5946,CHI,0,36463139,36465011,1872
5947,FA1,1,36463832,36464151,319
5948,FA1,4,36466151,36467030,879
5949,CHI,0,36467331,36467707,376
5950,FA1,4,36468024,36469209,1185
5951,CHI,0,36469155,36469771,616
5952,FC1,4,36470771,36472115,1344
5953,CHI,0,36471863,36479927,8064
5954,FA1,14,36474540,36478930,4390
5955,FA1,1,36479403,36479751,348
5956,FA1,12,36480199,36482907,2708
5957,CHI,0,36481199,36484399,3200
5958,CHI,0,36485015,36488383,3368
5959,FA1,4,36486476,36487488,1012
5960,FA1,3,36490448,36493987,3539
5961,CHI,1,36493499,36493815,316
5962,FA1,2,36494691,36495579,888
5963,CHI,0,36496224,36496567,343
5964,CHI,0,36497251,36497551,300
5965,FC1,0,36498197,36498987,790
5966,FA1,8,36499797,36501395,1598
5967,FC1,2,36501411,36501864,453
5968,FA1,4,36502417,36503451,1034
5969,CHI,0,36504743,36505739,996
5970,FA1,7,36504842,36507086,2244
5971,FC1,4,36505231,36507425,2194
5972,FA1,9,36507567,36509231,1664
5973,FA1,10,36509567,36511696,2129
5974,CHI,0,36511129,36511845,716
5975,FA1,8,36511850,36513039,1189
5976,FC1,2,36513348,36513905,557
5977,CHI,0,36513511,36513867,356
5978,FC1,4,36514442,36515631,1189
5979,FA1,13,36516278,36518243,1965
5980,CHI,0,36519543,36520459,916
5981,FA1,12,36524222,36527315,3093
5982,FA1,0,36528009,36529193,1184
5983,FA1,0,36529885,36531667,1782
5984,FA1,0,36534634,36535684,1050
5985,FA1,0,36536000,36537273,1273
5986,CHI,1,36536735,36538599,1864
5987,FC1,4,36539104,36540267,1163
5988,FA1,11,36541144,36543639,2495
5989,FC1,0,36544162,36545607,1445
5990,FA1,5,36545961,36546842,881
5991,FC1,0,36547162,36548277,1115
5992,CHI,0,36548767,36550359,1592
5993,FA1,7,36549666,36551114,1448
5994,FA1,15,36553418,36557071,3653
5995,FA1,4,36557639,36558306,667
5996,FA1,5,36559907,36560996,1089
5997,CHI,0,36562171,36562675,504
5998,FA1,5,36562706,36563843,1137
5999,CHI,0,36563863,36564163,300
6000,FA1,4,36566766,36567979,1213
6001,FC1,4,36569662,36571047,1385
6002,FA1,17,36570913,36574142,3229
6003,FC1,1,36574067,36574997,930
6004,CHI,0,36575223,36575915,692
6005,FA1,1,36576055,36577000,945
6006,FC1,1,36577363,36578199,836
6007,FC1,0,36579700,36581443,1743
6008,FC1,0,36582475,36582860,385
6009,FA1,1,36583027,36583956,929
6010,FA1,6,36584098,36585810,1712
6011,FA1,9,36589355,36591521,2166
6012,FA1,7,36592140,36593871,1731
6013,FA1,10,36595071,36596849,1778
6014,FC1,3,36597717,36598835,1118
6015,FA1,32,36598568,36607178,8610
6016,CHI,0,36601506,36601867,361
6017,CHI,0,36603445,36604091,646
6018,FA1,1,36608781,36609123,342
6019,FA1,12,36610114,36612919,2805
6020,FA1,4,36613806,36614635,829
6021,CHI,0,36625500,36627630,2130
6022,CHI,0,36635797,36636215,418
6023,CHI,0,36637575,36637809,234
6024,CHI,0,36638806,36639338,532
6025,CHI,0,36640171,36640687,516
6026,CHI,0,36642791,36643679,888
6027,FA1,1,36643769,36644531,762
6028,CHI,0,36644507,36645039,532
6029,CHI,0,36646875,36647175,300
6030,CHI,0,36651303,36651819,516
6031,CHI,0,36652239,36652999,760
6032,CHI,0,36653523,36653699,176
6033,CHI,0,36654991,36656343,1352
6034,CHI,0,36662679,36663067,388
6035,CHI,0,36664855,36665219,364
6036,CHI,0,36665295,36667531,2236
6037,CHI,0,36667743,36672479,4736
6038,FA1,10,36667877,36672267,4390
6039,FA1,4,36672733,36674047,1314
6040,CHI,0,36673159,36674227,1068
6041,CHI,0,36674771,36677091,2320
6042,CHI,0,36677247,36678703,1456
6043,CHI,0,36678911,36679831,920
6044,CHI,0,36680279,36682375,2096
6045,FA1,11,36682460,36685195,2735
6046,CHI,0,36683491,36685435,1944
6047,CHI,0,36685787,36689023,3236
6048,FA1,6,36686172,36687703,1531
6049,FA1,0,36688215,36689059,844
6050,FA1,0,36689127,36690051,924
6051,CHI,0,36689131,36691591,2460
6052,CHI,0,36691899,36694191,2292
6053,CHI,0,36694343,36696143,1800
6054,CHI,0,36696183,36700627,4444
6055,CHI,0,36700863,36701503,640
6056,FA1,0,36701064,36703079,2015
6057,CHI,0,36702379,36703483,1104
6058,FC1,3,36703952,36705247,1295
6059,FC1,6,36705538,36707415,1877
6060,FA1,6,36707352,36709167,1815
6061,CHI,0,36708331,36709503,1172
6062,CHI,0,36709887,36714379,4492
6063,FA1,4,36710061,36711083,1022
6064,FA1,5,36712857,36714899,2042
6065,FA1,1,36716468,36717355,887
6066,FA1,4,36718315,36719327,1012
6067,FA1,5,36720671,36721597,926
6068,CHI,0,36722270,36722443,173
6069,FA1,3,36722702,36723245,543
6070,FA1,3,36723788,36724319,531
6071,FA1,3,36725324,36725905,581
6072,FC1,4,36725997,36728244,2247
6073,FA1,1,36728651,36729083,432
6074,CHI,0,36729331,36729875,544
6075,FA1,6,36729373,36730047,674
6076,FA1,6,36730132,36731601,1469
6077,CHI,0,36730651,36731751,1100
6078,CHI,0,36732131,36733603,1472
6079,FA1,6,36732570,36733557,987
6080,CHI,0,36734003,36734555,552
6081,CHI,0,36734983,36735839,856
6082,FA1,3,36736436,36737231,795
6083,FA1,1,36738144,36738364,220
6084,FA1,1,36739122,36739298,176
6085,FA1,1,36740067,36740276,209
6086,FA1,2,36740720,36741335,615
6087,FA1,4,36742670,36744044,1374
6088,CHI,0,36743995,36744443,448
6089,FA1,3,36745456,36746357,901
6090,CHI,0,36747299,36747631,332
6091,CHI,0,36748367,36749315,948
6092,CHI,0,36749959,36750535,576
6093,CHI,0,36751883,36752191,308
6094,FC1,4,36753015,36757553,4538
6095,FA1,4,36758284,36759229,945
6096,FC1,6,36760422,36763083,2661
6097,CHI,0,36764211,36767395,3184
6098,FA1,1,36764891,36765399,508
6099,CHI,0,36769423,36769795,372
6100,CHI,0,36770423,36771499,1076
6101,FC1,1,36772927,36773663,736
6102,FA1,6,36778382,36779866,1484
6103,FA1,6,36780957,36781839,882
6104,FA1,7,36782088,36782923,835
6105,FC1,0,36783142,36786503,3361
6106,CHI,0,36793939,36795215,1276
6107,CHI,0,36797475,36797783,308
6108,CHI,0,36799119,36801083,1964
6109,CHI,0,36803951,36805051,1100
6110,FA1,11,36810530,36814047,3517
6111,FA1,1,36815085,36815392,307
6112,FA1,8,36815651,36816811,1160
6113,FA1,12,36817524,36819730,2206
6114,FA1,5,36823775,36824459,684
6115,FA1,7,36827543,36829051,1508
6116,FC1,6,36835604,36837447,1843
6117,FA1,3,36839145,36840021,876
6118,FC1,1,36840501,36840790,289
6119,FC1,5,36841216,36842984,1768
6120,FA1,7,36843323,36846011,2688
6121,FC1,5,36846119,36848631,2512
6122,FC1,7,36851015,36852808,1793
6123,FA1,6,36858839,36860439,1600
6124,FA1,4,36860459,36861279,820
6125,FA1,7,36862044,36863523,1479
6126,FA1,1,36866478,36866941,463
6127,CHI,0,36867539,36868375,836
6128,FA1,1,36867833,36868230,397
6129,FC1,3,36868783,36870139,1356
6130,FA1,7,36870813,36872557,1744
6131,FA1,2,36873156,36873727,571
6132,FC1,1,36874036,36874607,571
6133,FA1,1,36874677,36874966,289
6134,FC1,9,36876301,36879335,3034
6135,FA1,6,36880010,36881316,1306
6136,FA1,5,36882415,36884003,1588
6137,CHI,0,36884286,36885446,1160
6138,FC1,4,36884560,36885739,1179
6139,FA1,3,36886101,36887332,1231
6140,FC1,6,36887770,36889610,1840
6141,FA1,7,36889514,36891027,1513
6142,FC1,3,36892915,36894005,1090
6143,FA1,19,36895176,36898655,3479
6144,FA1,8,36899834,36901739,1905
6145,CHI,0,36902955,36904415,1460
6146,FA1,12,36925394,36927600,2206
6147,FA1,1,36928168,36928565,397
6148,FA1,13,36930938,36934059,3121
6149,FA1,1,36935575,36935891,316
6150,FA1,4,36939616,36940623,1007
6151,FA1,1,36942549,36943293,744
6152,CHI,0,36943319,36946499,3180
6153,FA1,7,36944756,36947051,2295
6154,FA1,9,36949874,36951576,1702
6155,CHI,0,36952220,36952559,339
6156,FA1,10,36953939,36955691,1752
6157,CHI,0,36956111,36956358,247
6158,FA1,6,36957399,36958527,1128
6159,FC1,10,36960052,36961932,1880
6160,CHI,0,36962131,36965375,3244
6161,FA1,11,36962833,36966255,3422
6162,FC1,1,36966302,36966507,205
6163,FA1,10,36966729,36969023,2294
6164,FA1,13,36970093,36972636,2543
6165,FA1,9,36972841,36974358,1517
6166,FC1,1,36974315,36974738,423
6167,FA1,5,36981468,36982899,1431
6168,FC1,1,36983072,36983629,557
6169,FA1,5,36984324,36985542,1218
6170,FA1,9,36986057,36988064,2007
6171,CHI,0,36990627,36991519,892
6172,FC1,6,36991520,36993387,1867
6173,CHI,0,36998095,36998487,392
6174,CHI,0,37001995,37002243,248
6175,FC1,1,37002442,37003091,649
6176,FA1,0,37002687,37005541,2854
6177,CHI,0,37003151,37004739,1588
6178,FC1,2,37006182,37011183,5001
6179,CHI,0,37012075,37012911,836
6180,FC1,0,37012217,37012912,695
6181,FC1,7,37014509,37018071,3562
6182,FA1,3,37018599,37019130,531
6183,FC1,5,37019379,37020967,1588
6184,FA1,6,37021636,37022564,928
6185,FC1,2,37022664,37023316,652
6186,FA1,15,37022855,37025529,2674
6187,FA1,15,37026531,37028651,2120
6188,FC1,2,37028672,37030629,1957
6189,FC1,0,37035409,37036657,1248
6190,FA1,4,37037985,37038900,915
6191,CHI,0,37038799,37039779,980
6192,CHI,0,37040035,37040807,772
6193,CHI,0,37041103,37041911,808
6194,CHI,0,37041939,37043283,1344
6195,FA1,8,37043576,37045158,1582
6196,FC1,6,37045211,37046587,1376
6197,FC1,1,37046977,37047410,433
6198,FC1,7,37052882,37054421,1539
6199,FA1,5,37054458,37056274,1816
6200,FA1,1,37056522,37056990,468
6201,FC1,5,37057135,37060455,3320
6202,FC1,6,37061697,37063846,2149
6203,FA1,5,37064048,37064977,929
6204,FA1,6,37065476,37066625,1149
6205,FC1,1,37066866,37067171,305
6206,FC1,4,37070665,37071708,1043
6207,FA1,7,37072825,37075024,2199
6208,FA1,7,37076722,37078507,1785
6209,FC1,5,37081044,37082209,1165
6210,FA1,2,37085444,37086683,1239
6211,FA1,16,37087586,37091686,4100
6212,CHI,0,37092286,37093146,860
6213,FA1,11,37093468,37095918,2450
6214,CHI,0,37093687,37094215,528
6215,CHI,0,37094871,37096011,1140
6216,FA1,1,37096345,37096921,576
6217,CHI,0,37096363,37097223,860
6218,FA1,4,37097187,37097717,530
6219,CHI,0,37097671,37098303,632
6220,FA1,1,37101798,37102771,973
6221,CHI,0,37102811,37103367,556
6222,CHI,0,37104223,37104983,760
6223,CHI,0,37105223,37108435,3212
6224,FC1,0,37107604,37108891,1287
6225,FC1,4,37109370,37111310,1940
6226,FA1,5,37111286,37113094,1808
6227,CHI,0,37111315,37112415,1100
6228,FA1,3,37119482,37120526,1044
6229,CHI,0,37121355,37122691,1336
6230,CHI,0,37122735,37130799,8064
6231,FA1,1,37132805,37133222,417
6232,CHI,0,37132923,37137387,4464
6233,CHI,0,37137443,37140259,2816
6234,FA1,1,37137731,37138451,720
6235,CHI,0,37140819,37142091,1272
6236,FC1,3,37141062,37143515,2453
6237,CHI,0,37143311,37175707,32396
6238,FA1,2,37144221,37147367,3146
6239,FC1,0,37147839,37149259,1420
6240,FA1,3,37149295,37151235,1940
6241,FC1,0,37151809,37153404,1595
6242,FA1,3,37153390,37155274,1884
6243,FA1,0,37156672,37158019,1347
6244,FC1,0,37159495,37160148,653
6245,FA1,0,37161736,37162555,819
6246,FC1,0,37164199,37165183,984
6247,FA1,0,37165923,37169567,3644
6248,FC1,0,37173515,37174656,1141
6249,FA1,1,37176172,37176755,583
6250,FA1,0,37177592,37179459,1867
6251,CHI,0,37177695,37187111,9416
6252,FC1,0,37180519,37181329,810
6253,FA1,1,37182164,37182647,483
6254,FC1,0,37183440,37184878,1438
6255,FA1,0,37184979,37186731,1752
6256,CHI,0,37189427,37201779,12352
6257,FA1,0,37191327,37192563,1236
6258,FA1,0,37196607,37198219,1612
6259,FA1,0,37199678,37201289,1611
6260,FA1,3,37202493,37203336,843
6261,CHI,0,37203463,37205299,1836
6262,CHI,0,37207767,37214455,6688
6263,FA1,1,37210451,37211750,1299
6264,FA1,1,37214911,37215588,677
6265,CHI,0,37214947,37221855,6908
6266,FC1,8,37216051,37218815,2764
6267,FA1,16,37218927,37222605,3678
6268,CHI,0,37221887,37222567,680
6269,CHI,0,37223203,37224103,900
6270,CHI,0,37224583,37224963,380
6271,CHI,0,37225623,37239255,13632
6272,FA1,3,37231115,37231962,847
6273,FA1,3,37232807,37233900,1093
6274,FA1,10,37234684,37237219,2535
6275,FA1,7,37237369,37239243,1874
6276,FA1,13,37239294,37242343,3049
6277,FC1,9,37243008,37245783,2775
6278,CHI,0,37246159,37251903,5744
6279,FA1,5,37246249,37248063,1814
6280,FA1,1,37250291,37250644,353
6281,FA1,3,37252289,37252755,466
6282,FA1,3,37255108,37255601,493
6283,FA1,6,37255916,37256757,841
6284,FC1,0,37258012,37258310,298
6285,FA1,16,37258559,37260862,2303
6286,FC1,3,37261138,37262043,905
6287,FA1,6,37262190,37263618,1428
6288,FA1,1,37264201,37264455,254
6289,FA1,1,37265084,37265482,398
6290,FA1,1,37266093,37266481,388
6291,FA1,6,37267938,37268684,746
6292,FA1,6,37272919,37273807,888
6293,FC1,1,37273841,37274275,434
6294,FC1,1,37275064,37275395,331
6295,FA1,10,37275993,37277983,1990
6296,FC1,2,37279032,37279391,359
6297,FA1,9,37283945,37285490,1545
6298,FA1,4,37285611,37286814,1203
6299,FA1,1,37287327,37287476,149
6300,CHI,0,37287673,37288551,878
6301,FA1,7,37288933,37290210,1277
6302,FC1,6,37289955,37291338,1383
6303,FA1,8,37291360,37293531,2171
6304,FC1,4,37292884,37295121,2237
6305,FA1,14,37295217,37298607,3390
6306,FA1,13,37299374,37301352,1978
6307,FA1,1,37301685,37301803,118
6308,FA1,1,37302752,37303011,259
6309,FA1,2,37303694,37303943,249
6310,FC1,3,37304819,37305975,1156
6311,FA1,9,37306919,37308695,1776
6312,FA1,2,37311216,37312054,838
6313,FA1,8,37312560,37313900,1340
6314,FC1,0,37314390,37315809,1419
6315,CHI,0,37315912,37316659,747
6316,FA1,8,37316875,37318027,1152
6317,CHI,0,37318180,37318533,353
6318,FC1,5,37319499,37321127,1628
6319,FA1,1,37321227,37321559,332
6320,FA1,11,37322383,37324154,1771
6321,FA1,9,37324289,37325293,1004
6322,CHI,0,37324699,37325591,892
6323,CHI,0,37325955,37327303,1348
6324,FA1,1,37326547,37326995,448
6325,FA1,1,37327981,37328727,746
6326,FA1,7,37329182,37331035,1853
6327,CHI,0,37331067,37331463,396
6328,FA1,3,37332984,37333822,838
6329,CHI,0,37334851,37335435,584
6330,FA1,2,37335975,37336271,296
6331,FA1,6,37336740,37337455,715
6332,CHI,0,37339103,37339875,772
6333,FA1,7,37340042,37341141,1099
6334,CHI,0,37341367,37342459,1092
6335,FA1,4,37342840,37343827,987
6336,FC1,7,37343967,37349583,5616
6337,FA1,1,37347690,37348025,335
6338,FA1,8,37351357,37353382,2025
6339,FA1,4,37353421,37354351,930
6340,CHI,0,37353987,37354340,353
6341,FC1,0,37354477,37356322,1845
6342,FA1,10,37362620,37365375,2755
6343,CHI,0,37365699,37366052,353
6344,CHI,0,37366535,37367171,636
6345,CHI,0,37367727,37368179,452
6346,CHI,0,37369111,37369303,192
6347,FA1,2,37369927,37370891,964
6348,FA1,3,37372169,37373126,957
6349,FA1,11,37373971,37375840,1869
6350,FC1,0,37376402,37376868,466
6351,FA1,4,37377275,37378356,1081
6352,FA1,1,37384776,37385049,273
6353,FA1,1,37386398,37386609,211
6354,CHI,0,37387467,37388335,868
6355,FA1,8,37388791,37389689,898
6356,CHI,0,37390335,37390955,620
6357,FA1,13,37391083,37393716,2633
6358,FC1,0,37393866,37396276,2410
6359,FA1,5,37396720,37400359,3639
6360,CHI,0,37397328,37398132,804
6361,FA1,5,37400953,37401891,938
6362,FA1,1,37407167,37408017,850
6363,FA1,1,37411763,37411911,148
6364,FA1,8,37413745,37415440,1695
6365,FA1,6,37415797,37416586,789
6366,CHI,0,37418515,37419403,888
6367,FA1,4,37420117,37421111,994
6368,FC1,0,37422727,37424503,1776
6369,FA1,9,37425529,37427318,1789
6370,FA1,2,37429876,37430305,429
6371,FC1,0,37431148,37434383,3235
6372,CHI,0,37439943,37440283,340
6373,CHI,0,37441079,37441315,236
6374,CHI,0,37442359,37442603,244
6375,FA1,2,37442968,37443856,888
6376,FA1,2,37444704,37445424,720
6377,FC1,0,37446235,37447092,857
6378,CHI,0,37446327,37446911,584
6379,CHI,0,37447539,37448243,704
6380,FC1,0,37447719,37449385,1666
6381,CHI,0,37448759,37449395,636
6382,FA1,16,37449708,37452919,3211
6383,FA1,3,37453930,37454676,746
6384,FC1,1,37455017,37455899,882
6385,FA1,2,37456517,37457368,851
6386,FC1,2,37458538,37459351,813
6387,FA1,4,37459802,37460951,1149
6388,FA1,10,37462907,37463959,1052
6389,FC1,0,37464170,37467800,3630
6390,FA1,2,37468191,37468888,697
6391,FA1,7,37477966,37479887,1921
6392,FA1,4,37480880,37481818,938
6393,FA1,3,37483926,37484590,664
6394,FC1,0,37486655,37487560,905
6395,FA1,7,37488639,37489876,1237
6396,FC1,0,37490249,37492119,1870
6397,FC1,1,37492563,37492917,354
6398,FA1,1,37493019,37493139,120
6399,FA1,9,37493489,37494698,1209
6400,FA1,2,37497380,37498077,697
6401,CHI,0,37498863,37499371,508
6402,FA1,4,37499938,37501082,1144
6403,FC1,2,37501675,37502347,672
6404,FA1,8,37502491,37504441,1950
6405,CHI,0,37503067,37503971,904
6406,FA1,3,37504507,37505727,1220
6407,CHI,0,37504515,37506503,1988
6408,FC1,0,37506671,37508835,2164
6409,CHI,0,37506831,37507315,484
6410,CHI,0,37508987,37509467,480
6411,FA1,7,37509987,37511311,1324
6412,FC1,4,37520206,37521241,1035
6413,CHI,0,37525851,37526447,596
6414,FA1,1,37526575,37526938,363
6415,FA1,5,37529278,37529994,716
6416,CHI,0,37531523,37532031,508
6417,FA1,8,37535849,37537769,1920
6418,FA1,6,37539575,37540849,1274
6419,FC1,5,37561727,37563048,1321
6420,FA1,0,37563143,37563792,649
6421,CHI,0,37563307,37564551,1244
6422,FA1,4,37564734,37565679,945
6423,FA1,1,37567915,37568282,367
6424,FA1,6,37571279,37572551,1272
6425,CHI,0,37573167,37573803,636
6426,FA1,6,37574231,37575780,1549
6427,FC1,0,37579497,37581227,1730
6428,FC1,3,37581427,37584707,3280
6429,FA1,17,37586747,37591367,4620
6430,FA1,1,37593004,37593492,488
6431,FA1,6,37593953,37595800,1847
6432,FA1,7,37599597,37601902,2305
6433,FC1,4,37605894,37606756,862
6434,FA1,7,37607134,37609379,2245
6435,FA1,7,37610686,37613053,2367
6436,CHI,0,37613687,37614155,468
6437,FA1,4,37614234,37615555,1321
6438,CHI,0,37615679,37616551,872
6439,FC1,0,37619747,37621939,2192
6440,FA1,18,37621153,37625819,4666
6441,FA1,4,37627757,37628856,1099
6442,FA1,3,37629517,37630199,682
6443,FA1,13,37630275,37632819,2544
6444,FA1,7,37633229,37634855,1626
6445,FC1,0,37634942,37635607,665
6446,FC1,1,37639051,37639745,694
6447,FA1,6,37642076,37643328,1252
6448,FA1,5,37645637,37646942,1305
6449,FC1,2,37647178,37648010,832
6450,FA1,13,37648487,37650922,2435
6451,FA1,2,37655679,37656214,535
6452,FA1,3,37662219,37662946,727
6453,FA1,2,37663996,37665079,1083
6454,CHI,0,37666763,37667215,452
6455,FA1,9,37668770,37670625,1855
6456,FA1,4,37673877,37675030,1153
6457,FA1,7,37675446,37676547,1101
6458,FA1,2,37677159,37678051,892
6459,FC1,0,37678145,37679505,1360
6460,FA1,1,37679882,37680813,931
6461,FA1,4,37684191,37687115,2924
6462,FA1,14,37687697,37690979,3282
6463,CHI,0,37688847,37692247,3400
6464,FA1,4,37692590,37694035,1445
6465,CHI,0,37693019,37695599,2580
6466,FA1,4,37695142,37696424,1282
6467,FA1,4,37697528,37698268,740
6468,CHI,0,37698887,37702039,3152
6469,FA1,3,37699290,37701158,1868
6470,FA1,1,37702155,37702285,130
6471,CHI,0,37702979,37703871,892
6472,FA1,5,37703798,37704966,1168
6473,FC1,0,37704880,37706581,1701
6474,CHI,0,37705032,37709343,4311
6475,FA1,12,37707607,37710401,2794
6476,CHI,0,37710491,37712887,2396
6477,FA1,7,37713267,37715362,2095
6478,CHI,0,37715275,37716475,1200
6479,FA1,1,37716261,37717276,1015
6480,FC1,3,37717231,37718185,954
6481,CHI,0,37718343,37721931,3588
6482,FA1,0,37719456,37721525,2069
6483,FA1,0,37721965,37722682,717
6484,CHI,0,37722583,37723863,1280
6485,CHI,0,37723931,37727415,3484
6486,FA1,7,37725780,37727979,2199
6487,FC1,3,37728546,37729058,512
6488,CHI,0,37729575,37733223,3648
6489,CHI,0,37734751,37738863,4112
6490,FA1,6,37736163,37737367,1204
6491,CHI,0,37738971,37741595,2624
6492,FA1,4,37740051,37741035,984
6493,CHI,0,37742275,37742795,520
6494,FA1,11,37743123,37745459,2336
6495,CHI,0,37745771,37747535,1764
6496,FA1,5,37746018,37747515,1497
6497,FA1,1,37747627,37747818,191
6498,FA1,1,37748745,37749012,267
6499,FC1,4,37749504,37750794,1290
6500,FC1,5,37753380,37754587,1207
6501,FA1,12,37754698,37758263,3565
6502,CHI,0,37757071,37763259,6188
6503,FC1,6,37759319,37761759,2440
6504,FA1,17,37762772,37766459,3687
6505,FA1,8,37767704,37768963,1259
6506,CHI,0,37769291,37769659,368
6507,CHI,0,37771335,37771611,276
6508,CHI,0,37772427,37780259,7832
6509,FC1,7,37784287,37786927,2640
6510,FA1,5,37786933,37788238,1305
6511,FA1,11,37789150,37793239,4089
6512,FA1,5,37793896,37795965,2069
6513,FA1,7,37796476,37798179,1703
6514,FA1,14,37798875,37802951,4076
6515,FA1,3,37803439,37804471,1032
6516,FA1,10,37804867,37806896,2029
6517,FC1,3,37805919,37807003,1084
6518,FC1,0,37807525,37811411,3886
6519,FA1,25,37811145,37815985,4840
6520,FC1,1,37816056,37816375,319
6521,FA1,5,37817261,37818123,862
6522,FA1,9,37822263,37824335,2072
6523,CHI,0,37824515,37824739,224
6524,FA1,7,37824904,37826531,1627
6525,FC1,2,37824971,37825531,560
6526,FA1,8,37827023,37829195,2172
6527,FC1,6,37829871,37832427,2556
6528,FA1,4,37830343,37830911,568
6529,FA1,4,37832619,37833774,1155
6530,FC1,7,37835871,37837671,1800
6531,FA1,4,37837999,37839591,1592
6532,FC1,1,37840510,37840794,284
6533,CHI,0,37841635,37842575,940
6534,FA1,1,37843179,37844129,950
6535,CHI,0,37847601,37849497,1896
6536,FA1,8,37849733,37850881,1148
6537,FC1,5,37851911,37855259,3348
6538,FA1,5,37853132,37853951,819
6539,FC1,0,37855331,37857183,1852
6540,FA1,7,37856547,37858223,1676
6541,FC1,1,37858513,37858739,226
6542,FA1,8,37858884,37860139,1255
6543,FC1,10,37859935,37864811,4876
6544,FA1,6,37864939,37867315,2376
6545,FC1,5,37867458,37868707,1249
6546,FA1,8,37868963,37870535,1572
6547,FA1,6,37871311,37874759,3448
6548,FC1,0,37872383,37873959,1576
6549,CHI,0,37875907,37876422,515
6550,FA1,1,37876559,37877251,692
6551,CHI,0,37877383,37877823,440
6552,FA1,4,37878291,37879361,1070
6553,FC1,4,37879331,37881217,1886
6554,FA1,10,37881519,37884182,2663
6555,FC1,3,37884246,37885296,1050
6556,FA1,7,37885739,37887095,1356
6557,CHI,0,37887467,37888395,928
6558,FC1,1,37887516,37887720,204
6559,FC1,6,37889455,37892940,3485
6560,FA1,15,37893223,37896118,2895
6561,FA1,5,37896737,37898205,1468
6562,FC1,2,37897769,37898982,1213
6563,FA1,1,37900033,37900530,497
6564,FC1,4,37901437,37902806,1369
6565,FA1,3,37903100,37903823,723
6566,FC1,1,37904429,37904855,426
6567,FC1,4,37905500,37907677,2177
6568,FA1,3,37907795,37908830,1035
6569,FA1,3,37909014,37909681,667
6570,FC1,4,37909772,37910438,666
6571,CHI,0,37911135,37911559,424
6572,FA1,6,37912218,37913856,1638
6573,CHI,0,37913743,37914759,1016
6574,FC1,4,37915008,37916703,1695
6575,FA1,7,37916884,37918109,1225
6576,FA1,4,37918109,37919309,1200
6577,FC1,1,37920991,37921395,404
6578,FA1,5,37921945,37923058,1113
6579,FC1,4,37924551,37926083,1532
6580,FA1,4,37928077,37929034,957
6581,FC1,4,37930304,37931949,1645
6582,FA1,8,37932239,37934254,2015
6583,FC1,5,37936600,37937756,1156
6584,FA1,9,37938847,37941010,2163
6585,FC1,6,37941538,37943368,1830
6586,FA1,6,37943531,37945481,1950
6587,FC1,9,37946967,37949871,2904
6588,FA1,1,37948483,37948965,482
6589,FA1,10,37949745,37952063,2318
6590,FA1,2,37953123,37953775,652
6591,FA1,5,37956690,37957853,1163
6592,FC1,0,37957275,37962167,4892
6593,FA1,6,37962694,37963793,1099
6594,FC1,3,37964598,37966051,1453
6595,FA1,4,37967644,37968523,879
6596,FC1,0,37968750,37969125,375
6597,FA1,7,37969242,37970859,1617
6598,FA1,0,37971519,37971852,333
6599,FA1,15,37972295,37974571,2276
6600,CHI,0,37978667,37979035,368
6601,FC1,2,37979290,37979765,475
6602,FC1,2,37980591,37981227,636
6603,FC1,2,37981514,37985458,3944
6604,CHI,0,37983283,37984163,880
6605,FA1,3,37984083,37985047,964
6606,FA1,1,37985933,37986578,645
6607,FA1,2,37986893,37987922,1029
6608,FA1,12,37990194,37992331,2137
6609,FC1,1,37991383,37991652,269
6610,CHI,0,37992259,37992615,356
6611,FA1,4,37992779,37993455,676
6612,CHI,0,37994239,37994551,312
6613,FA1,5,37994907,37995988,1081
6614,FC1,0,37995972,37997958,1986
6615,CHI,0,37996127,37996375,248
6616,FA1,1,37996563,37997158,595
6617,FA1,1,37997799,37998147,348
6618,FA1,3,37998358,37998840,482
6619,FA1,4,37999563,38000244,681
6620,CHI,0,38000431,38007175,6744
6621,FA1,2,38000945,38001570,625
6622,FA1,11,38002420,38005498,3078
6623,FA1,10,38005530,38008335,2805
6624,CHI,0,38010411,38012867,2456
6625,FA1,0,38010796,38011222,426
6626,FA1,0,38013058,38013910,852
6627,FC1,1,38013613,38014335,722
6628,CHI,0,38013647,38014451,804
6629,FA1,0,38014633,38015217,584
6630,CHI,0,38017459,38018399,940
6631,FA1,4,38019057,38019760,703
6632,FC1,4,38020068,38021256,1188
6633,FA1,10,38021573,38024642,3069
6634,FA1,4,38025038,38025978,940
6635,FA1,2,38027804,38028576,772
6636,CHI,0,38029439,38032295,2856
6637,FA1,3,38032459,38033321,862
6638,CHI,0,38033311,38036171,2860
6639,FA1,7,38034167,38035830,1663
6640,FA1,20,38036552,38040493,3941
6641,FC1,0,38041333,38042076,743
6642,FA1,5,38043050,38045466,2416
6643,FC1,2,38045992,38046954,962
6644,FC1,5,38047594,38049723,2129
6645,FA1,14,38050509,38053627,3118
6646,CHI,0,38053929,38057587,3658
6647,FA1,8,38058483,38059968,1485
6648,FA1,6,38061255,38062601,1346
6649,FC1,0,38065511,38067145,1634
6650,FA1,8,38067823,38069466,1643
6651,FA1,8,38070169,38071959,1790
6652,FC1,2,38072492,38073113,621
6653,FA1,12,38073559,38076519,2960
6654,FA1,5,38078316,38079555,1239
6655,FA1,6,38087599,38089219,1620
6656,FA1,1,38096175,38096571,396
6657,FA1,5,38097541,38098931,1390
6658,CHI,0,38099031,38107439,8408
6659,FA1,7,38099774,38105304,5530
6660,FC1,1,38104645,38105271,626
6661,FA1,1,38105309,38105789,480
6662,FC1,4,38106748,38108295,1547
6663,CHI,0,38108754,38111507,2753
6664,FA1,8,38109298,38111199,1901
6665,FA1,30,38112020,38117479,5459
6666,CHI,0,38118727,38124659,5932
6667,FA1,4,38122273,38124708,2435
6668,CHI,0,38124767,38129659,4892
6669,FA1,6,38127489,38129351,1862
6670,FC1,3,38129747,38131143,1396
6671,FA1,7,38131158,38133475,2317
6672,FA1,2,38135102,38135913,811
6673,FC1,4,38136002,38138497,2495
6674,FA1,6,38137457,38139081,1624
6675,CHI,0,38139479,38141023,1544
6676,FA1,5,38142130,38144595,2465
6677,FC1,0,38145194,38147005,1811
6678,FA1,1,38147534,38148742,1208
6679,FA1,5,38149593,38151395,1802
6680,FA1,5,38154018,38155632,1614
6681,FA1,15,38156629,38160109,3480
6682,CHI,0,38159291,38159827,536
6683,CHI,0,38160419,38160875,456
6684,FA1,1,38161172,38161615,443
6685,CHI,0,38162095,38162631,536
6686,FA1,5,38162651,38163459,808
6687,CHI,0,38164707,38165451,744
6688,FA1,6,38165535,38166875,1340
6689,FA1,5,38167875,38168789,914
6690,CHI,0,38173211,38174043,832
6691,FA1,1,38174280,38174884,604
6692,FA1,9,38180814,38182423,1609
6693,FA1,9,38183138,38184918,1780
6694,FA1,3,38186138,38186882,744
6695,FA1,0,38187240,38187623,383
6696,FC1,1,38188466,38189055,589
6697,FA1,6,38189022,38192171,3149
6698,FC1,1,38190440,38190865,425
6699,FC1,2,38192205,38192829,624
6700,FA1,1,38192595,38192836,241
6701,FC1,8,38193318,38196539,3221
6702,FA1,4,38196565,38197495,930
6703,FA1,4,38198972,38200121,1149
6704,FC1,10,38201289,38205112,3823
6705,CHI,0,38201687,38202339,652
6706,FA1,6,38205448,38206795,1347
6707,FC1,1,38206757,38207211,454
6708,FA1,20,38207325,38210543,3218
6709,CHI,0,38208395,38211907,3512
6710,FA1,1,38210615,38210970,355
6711,CHI,0,38212355,38213331,976
6712,CHI,0,38213887,38217483,3596
6713,FA1,1,38214311,38214785,474
6714,CHI,0,38217571,38227471,9900
6715,FA1,5,38217996,38219199,1203
6716,FA1,4,38221008,38222117,1109
6717,FC1,4,38222747,38223733,986
6718,FA1,8,38223752,38225482,1730
6719,FA1,0,38225553,38226326,773
6720,FA1,2,38226517,38227479,962
6721,CHI,0,38228107,38228631,524
6722,FA1,0,38228653,38229635,982
6723,FC1,0,38229661,38230443,782
6724,CHI,0,38231147,38231923,776
6725,FA1,0,38231474,38231939,465
6726,CHI,0,38232255,38235243,2988
6727,FA1,7,38233050,38235050,2000
6728,CHI,0,38236051,38238899,2848
6729,FA1,6,38237025,38238925,1900
6730,CHI,0,38239379,38239779,400
6731,FA1,5,38240086,38242819,2733
6732,CHI,0,38244163,38244571,408
6733,FA1,7,38245844,38248295,2451
6734,CHI,0,38248759,38249871,1112
6735,FA1,1,38249987,38250750,763
6736,CHI,0,38251195,38251615,420
6737,FA1,3,38252324,38252944,620
6738,CHI,0,38252895,38256547,3652
6739,CHI,0,38257531,38258415,884
6740,FA1,1,38258932,38259486,554
6741,CHI,0,38259451,38261747,2296
6742,FA1,4,38260218,38261672,1454
6743,CHI,0,38262079,38262683,604
6744,FA1,8,38262540,38264606,2066
6745,FA1,3,38265243,38266210,967
6746,FA1,3,38266635,38267412,777
6747,CHI,0,38267483,38270979,3496
6748,FA1,4,38269165,38270430,1265
6749,CHI,0,38271631,38274691,3060
6750,FA1,7,38272368,38274551,2183
6751,FA1,3,38275451,38276427,976
6752,FC1,3,38276187,38277485,1298
6753,CHI,0,38278135,38279151,1016
6754,FA1,12,38280521,38282587,2066
6755,CHI,0,38281445,38282474,1029
6756,FA1,8,38283257,38284844,1587
6757,FA1,5,38286249,38287447,1198
6758,CHI,0,38287447,38287775,328
6759,CHI,0,38288191,38288327,136
6760,FA1,5,38288327,38288987,660
6761,FA1,1,38289483,38289905,422
6762,CHI,0,38290527,38293243,2716
6763,FA1,6,38291036,38292391,1355
6764,FC1,8,38296224,38300381,4157
6765,CHI,0,38298483,38299647,1164
6766,FA1,11,38300827,38302687,1860
6767,CHI,0,38302723,38303435,712
6768,FA1,6,38303707,38305112,1405
6769,FA1,6,38305624,38307959,2335
6770,CHI,0,38307303,38307763,460
6771,FA1,7,38308652,38310671,2019
6772,FA1,8,38311983,38313972,1989
6773,FC1,3,38313616,38314897,1281
6774,FA1,1,38315025,38315863,838
6775,FA1,14,38316987,38320097,3110
6776,CHI,0,38320415,38321227,812
6777,CHI,0,38323863,38324075,212
6778,FC1,0,38325116,38326364,1248
6779,CHI,0,38325795,38326211,416
6780,CHI,0,38326607,38326995,388
6781,FA1,6,38326917,38328307,1390
6782,FC1,1,38328645,38328967,322
6783,CHI,0,38328947,38330243,1296
6784,FA1,2,38329661,38330231,570
6785,CHI,0,38330399,38331135,736
6786,CHI,0,38332111,38332735,624
6787,FA1,2,38333975,38334396,421
6788,FC1,2,38334673,38337615,2942
6789,FA1,2,38335735,38336272,537
6790,CHI,0,38336267,38336855,588
6791,FA1,7,38338136,38339996,1860
6792,FC1,0,38339736,38342496,2760
6793,FA1,8,38342579,38344116,1537
6794,FC1,4,38344228,38347327,3099
6795,FA1,6,38347938,38349376,1438
6796,FC1,7,38349269,38351847,2578
6797,FA1,5,38352046,38353267,1221
6798,FC1,1,38353385,38353643,258
6799,FA1,2,38359335,38360019,684
6800,FA1,13,38361887,38364539,2652
6801,FC1,1,38364950,38365811,861
6802,FA1,1,38365963,38366763,800
6803,FC1,7,38367291,38369579,2288
6804,FA1,13,38370492,38373635,3143
6805,FA1,1,38374392,38375030,638
6806,FC1,7,38375249,38378865,3616
6807,FA1,6,38378914,38380024,1110
6808,FC1,1,38380188,38380826,638
6809,FA1,30,38380941,38387281,6340
6810,FA1,2,38388467,38389079,612
6811,FC1,1,38388987,38389279,292
6812,FA1,1,38389651,38389798,147
6813,FC1,5,38392825,38394835,2010
6814,FA1,8,38396384,38399216,2832
6815,FC1,5,38399453,38402968,3515
6816,FA1,1,38403802,38404901,1099
6817,FC1,5,38406143,38407095,952
6818,FA1,1,38407185,38408343,1158
6819,FA1,9,38409842,38412439,2597
6820,FA1,11,38415114,38417057,1943
6821,FC1,2,38417503,38418854,1351
6822,FA1,7,38418889,38420628,1739
6823,CHI,0,38423375,38424404,1029
6824,FA1,8,38424320,38426307,1987
6825,FA1,1,38426556,38426694,138
6826,CHI,0,38426743,38427215,472
6827,FA1,7,38427594,38429291,1697
6828,FA1,4,38431434,38432216,782
6829,FA1,5,38432679,38433363,684
6830,CHI,0,38433563,38433983,420
6831,CHI,0,38435543,38435887,344
6832,FA1,4,38436315,38437231,916
6833,CHI,0,38438371,38438547,176
6834,FA1,3,38441471,38442079,608
6835,CHI,0,38446119,38446979,860
6836,FA1,10,38447301,38449021,1720
6837,CHI,0,38449363,38449551,188
6838,CHI,0,38454691,38454915,224
6839,FA1,3,38460810,38461317,507
6840,CHI,0,38463007,38463247,240
6841,FA1,1,38463743,38464027,284
6842,FC1,7,38464285,38466719,2434
6843,FA1,7,38466920,38468745,1825
6844,FC1,8,38470117,38471908,1791
6845,FA1,8,38471895,38474059,2164
6846,CHI,0,38474347,38475179,832
6847,FA1,10,38474637,38477035,2398
6848,FA1,2,38477289,38477858,569
6849,FC1,8,38478297,38480553,2256
6850,FA1,10,38480634,38482904,2270
6851,FA1,7,38483233,38484873,1640
6852,CHI,0,38488479,38489051,572
6853,FA1,2,38489470,38489887,417
6854,CHI,0,38490031,38490351,320
6855,FA1,1,38490530,38490720,190
6856,FA1,7,38491532,38492948,1416
6857,CHI,0,38493199,38495179,1980
6858,FA1,3,38496500,38496957,457
6859,CHI,0,38497111,38497395,284
6860,FA1,1,38497892,38498793,901
6861,CHI,0,38501899,38502283,384
6862,FA1,1,38502608,38502844,236
6863,FA1,14,38503413,38506702,3289
6864,CHI,0,38509351,38509723,372
6865,FA1,3,38509855,38510556,701
6866,FA1,3,38511150,38511901,751
6867,FA1,3,38512579,38513067,488
6868,FA1,3,38514950,38515456,506
6869,CHI,0,38516255,38516739,484
6870,FA1,3,38517215,38517916,701
6871,CHI,0,38518203,38518975,772
6872,CHI,0,38519875,38522887,3012
6873,FA1,2,38523003,38523958,955
6874,FA1,3,38524686,38525559,873
6875,FA1,2,38525823,38526233,410
6876,FA1,1,38532551,38533972,1421
6877,FC1,1,38536208,38536990,782
6878,FA1,2,38539565,38539922,357
6879,FA1,0,38541174,38541386,212
6880,CHI,0,38541999,38542283,284
6881,FA1,2,38542893,38543250,357
6882,CHI,0,38543571,38543779,208
6883,FA1,1,38544192,38545952,1760
6884,FA1,3,38546044,38546891,847
6885,FA1,1,38548263,38548887,624
6886,FA1,14,38551367,38553927,2560
6887,FA1,1,38555477,38555880,403
6888,FA1,1,38556309,38557409,1100
6889,FA1,14,38557706,38560220,2514
6890,FA1,6,38560279,38561612,1333
6891,FA1,5,38562039,38563187,1148
6892,FA1,1,38564508,38564724,216
6893,FA1,3,38565324,38566077,753
6894,FA1,7,38567809,38569231,1422
6895,FA1,4,38569999,38570776,777
6896,FA1,2,38570932,38571454,522
6897,CHI,0,38572083,38572735,652
6898,FA1,3,38573840,38574709,869
6899,CHI,1,38575403,38576167,764
6900,FA1,2,38576318,38577083,765
6901,CHI,0,38577127,38578439,1312
6902,CHI,0,38579147,38582323,3176
6903,FA1,1,38580012,38580650,638
6904,CHI,0,38582871,38584819,1948
6905,CHI,0,38584935,38585799,864
6906,FA1,6,38584935,38587491,2556
6907,CHI,0,38586951,38588691,1740
6908,CHI,0,38589095,38592159,3064
6909,FA1,1,38591900,38592089,189
6910,FA1,3,38592482,38594274,1792
6911,FA1,4,38595944,38597849,1905
6912,CHI,0,38599495,38602495,3000
6913,FA1,5,38601043,38602441,1398
6914,FA1,15,38602887,38605575,2688
6915,FC1,2,38605563,38607970,2407
6916,CHI,0,38605887,38606747,860
6917,CHI,0,38607207,38608107,900
6918,FA1,1,38608115,38608375,260
6919,CHI,0,38608759,38613139,4380
6920,FA1,8,38610960,38613065,2105
6921,CHI,0,38615263,38616619,1356
6922,FA1,1,38615549,38616017,468
6923,CHI,0,38617699,38619455,1756
6924,FA1,0,38618819,38620108,1289
6925,FA1,1,38621383,38622008,625
6926,FA1,3,38626165,38626715,550
6927,FA1,7,38627217,38628412,1195
6928,FC1,0,38628497,38630999,2502
6929,FA1,9,38631100,38632962,1862
6930,FA1,7,38636713,38638078,1365
6931,FA1,16,38638602,38641763,3161
6932,FA1,7,38644348,38645443,1095
6933,FA1,1,38646765,38647163,398
6934,FA1,6,38647670,38648732,1062
6935,FC1,6,38649302,38651068,1766
6936,FA1,1,38649540,38649895,355
6937,FA1,6,38651093,38651993,900
6938,FA1,13,38652489,38654768,2279
6939,FA1,1,38658267,38658684,417
6940,FC1,4,38659534,38661287,1753
6941,CHI,0,38659907,38660563,656
6942,FA1,15,38662931,38666135,3204
6943,CHI,0,38665113,38667603,2490
6944,FA1,22,38666439,38671529,5090
6945,FA1,2,38672998,38673650,652
6946,FA1,5,38674032,38675165,1133
6947,FA1,11,38676741,38678827,2086
6948,FA1,7,38680019,38681161,1142
6949,FA1,6,38682458,38683492,1034
6950,FA1,4,38684236,38685004,768
6951,CHI,0,38685499,38693435,7936
6952,FA1,4,38686034,38687485,1451
6953,FA1,3,38688200,38688802,602
6954,FA1,7,38690685,38692694,2009
6955,CHI,0,38693467,38695339,1872
6956,FA1,8,38695815,38697621,1806
6957,FC1,3,38697915,38699167,1252
6958,FA1,0,38699101,38700395,1294
6959,CHI,0,38699691,38700459,768
6960,FA1,13,38700420,38702756,2336
6961,CHI,0,38702443,38703211,768
6962,CHI,0,38703435,38704739,1304
6963,FA1,4,38703912,38704581,669
6964,FA1,1,38705159,38705367,208
6965,FA1,1,38705796,38706004,208
6966,FA1,7,38706763,38709143,2380
6967,CHI,1,38710943,38711464,521
6968,FA1,1,38711641,38712021,380
6969,CHI,0,38713739,38714187,448
6970,FA1,8,38714282,38716048,1766
6971,FA1,6,38716428,38719687,3259
6972,CHI,0,38716647,38717075,428
6973,CHI,0,38720611,38721035,424
6974,FC1,5,38722862,38724278,1416
6975,FA1,6,38724277,38725307,1030
6976,FC1,2,38725320,38726647,1327
6977,CHI,0,38725339,38725727,388
6978,FA1,8,38726939,38728834,1895
6979,FC1,4,38727973,38729459,1486
6980,FC1,0,38729570,38730563,993
6981,FA1,8,38730636,38732659,2023
6982,FC1,0,38731589,38733137,1548
6983,FA1,10,38732990,38735375,2385
6984,CHI,0,38735199,38735967,768
6985,FA1,10,38737916,38740388,2472
6986,FA1,7,38740474,38742036,1562
6987,FC1,2,38741558,38742175,617
6988,CHI,0,38742559,38743103,544
6989,FA1,7,38742906,38744591,1685
6990,FA1,1,38747519,38747911,392
6991,FC1,1,38749975,38750231,256
6992,FA1,2,38750880,38751647,767
6993,FC1,5,38753255,38754343,1088
6994,CHI,0,38754879,38755891,1012
6995,FC1,2,38755502,38756686,1184
6996,CHI,0,38756443,38757307,864
6997,CHI,0,38758267,38758511,244
6998,FC1,1,38760352,38760571,219
6999,CHI,0,38764667,38765067,400
7000,CHI,0,38766183,38766863,680
7001,FA1,4,38766527,38767486,959
7002,FA1,14,38768429,38772435,4006
7003,CHI,0,38771923,38772455,532
7004,FA1,3,38775221,38776085,864
7005,FC1,1,38776239,38776517,278
7006,CHI,0,38783247,38783831,584
7007,FA1,6,38783909,38785321,1412
7008,CHI,0,38786167,38786639,472
7009,FA1,3,38786837,38787675,838
7010,CHI,0,38789611,38790271,660
7011,FA1,4,38790872,38792365,1493
7012,CHI,0,38797379,38798807,1428
7013,FA1,4,38797391,38798687,1296
7014,CHI,0,38799083,38799519,436
7015,FA1,16,38801019,38804863,3844
7016,FA1,4,38806012,38808203,2191
7017,CHI,0,38809375,38809739,364
7018,FA1,4,38809527,38810451,924
7019,FA1,4,38811273,38812644,1371
7020,FA1,5,38813131,38814176,1045
7021,CHI,0,38816151,38816471,320
7022,FA1,4,38817410,38818406,996
7023,FA1,2,38818600,38818885,285
7024,FA1,3,38820476,38821539,1063
7025,FA1,6,38823944,38825261,1317
7026,FC1,1,38825299,38827828,2529
7027,CHI,0,38826523,38828307,1784
7028,FA1,8,38827878,38829788,1910
7029,CHI,0,38828591,38830443,1852
7030,FA1,4,38830595,38834087,3492
7031,CHI,0,38834119,38836231,2112
7032,FA1,1,38836577,38837563,986
7033,CHI,0,38838051,38839679,1628
7034,FA1,10,38839504,38841332,1828
7035,CHI,0,38841499,38843015,1516
7036,FC1,0,38843107,38845301,2194
7037,FA1,11,38846167,38848601,2434
7038,FA1,6,38849215,38850383,1168
7039,FC1,1,38852353,38852901,548
7040,FC1,2,38853599,38854251,652
7041,CHI,0,38854271,38854839,568
7042,FC1,0,38855066,38856252,1186
7043,FA1,1,38856668,38857188,520
7044,FC1,0,38857262,38858403,1141
7045,CHI,0,38859755,38860175,420
7046,CHI,0,38860823,38861715,892
7047,FA1,11,38861672,38865032,3360
7048,FA1,6,38866175,38867405,1230
7049,FA1,6,38867675,38868757,1082
7050,FC1,0,38868955,38870535,1580
7051,FA1,6,38870790,38871957,1167
7052,FA1,5,38872669,38874040,1371
7053,CHI,0,38874395,38875163,768
7054,FA1,1,38875661,38877163,1502
7055,FA1,7,38877595,38880141,2546
7056,FA1,6,38880795,38884119,3324
7057,FA1,6,38884556,38887575,3019
7058,CHI,0,38886691,38888327,1636
7059,FA1,2,38888281,38889231,950
7060,FA1,2,38890274,38891903,1629
7061,CHI,0,38892247,38892779,532
7062,FA1,1,38893155,38894191,1036
7063,FC1,0,38897508,38898282,774
7064,CHI,0,38898411,38900551,2140
7065,FA1,1,38899754,38900153,399
7066,FC1,4,38900201,38901179,978
7067,FC1,6,38901858,38904514,2656
7068,CHI,0,38906715,38907059,344
7069,FA1,7,38908176,38909335,1159
7070,FC1,7,38908610,38910799,2189
7071,FA1,4,38910978,38912218,1240
7072,CHI,0,38911815,38913343,1528
7073,FA1,0,38914097,38915138,1041
7074,FA1,4,38915491,38918391,2900
7075,FC1,3,38917791,38919651,1860
7076,FA1,6,38920044,38922266,2222
7077,CHI,0,38922287,38922759,472
7078,FA1,5,38923257,38924899,1642
7079,CHI,1,38925195,38925963,768
7080,FA1,4,38925221,38926683,1462
7081,CHI,0,38926747,38927055,308
7082,FC1,1,38927199,38928072,873
7083,FA1,6,38929334,38931291,1957
7084,FA1,2,38932117,38932981,864
7085,CHI,0,38938987,38940263,1276
7086,CHI,0,38940863,38941631,768
7087,FA1,1,38942069,38942483,414
7088,CHI,0,38943747,38944199,452
7089,FA1,1,38944230,38944543,313
7090,FA1,8,38945427,38948883,3456
7091,CHI,0,38947847,38949619,1772
7092,FA1,7,38949071,38952015,2944
7093,FC1,0,38954615,38956867,2252
7094,FC1,0,38957720,38958751,1031
7095,FA1,10,38959105,38961155,2050
7096,CHI,0,38961905,38965514,3609
7097,FA1,1,38965071,38967083,2012
7098,FA1,4,38967164,38969007,1843
7099,CHI,0,38969863,38972067,2204
7100,FA1,8,38972670,38975247,2577
7101,CHI,0,38975167,38977259,2092
7102,FA1,4,38979338,38980965,1627
7103,CHI,0,38981187,38981955,768
7104,FC1,0,38982941,38985259,2318
7105,FC1,0,38985663,38988169,2506
7106,FA1,3,38986271,38991783,5512
7107,CHI,0,38991831,38993155,1324
7108,FA1,1,38993227,38993911,684
7109,CHI,0,38994019,38998715,4696
7110,FC1,0,38995237,38996560,1323
7111,FA1,1,38996494,38998774,2280
7112,FA1,6,38999013,39001846,2833
7113,CHI,0,39000359,39001795,1436
7114,CHI,0,39002351,39003203,852
7115,FA1,4,39003807,39005702,1895
7116,FC1,5,39005021,39007661,2640
7117,CHI,0,39007205,39007373,168
7118,CHI,0,39008799,39008967,168
7119,CHI,0,39010703,39010923,220
7120,FA1,1,39011415,39011676,261
7121,CHI,0,39012619,39012787,168
7122,FA1,0,39014039,39014275,236
7123,CHI,0,39015963,39016211,248
7124,CHI,0,39017267,39017435,168
7125,CHI,0,39017824,39018187,363
7126,FC1,0,39018619,39020017,1398
7127,FA1,15,39020205,39024151,3946
7128,CHI,0,39023943,39024431,488
7129,FA1,8,39024631,39026165,1534
7130,FA1,2,39030002,39032148,2146
7131,FA1,0,39033916,39034466,550
7132,CHI,0,39034527,39036083,1556
7133,CHI,0,39036455,39037327,872
7134,CHI,0,39037879,39039127,1248
7135,CHI,0,39039923,39040227,304
7136,CHI,0,39042227,39042491,264
7137,FA1,0,39043148,39043283,135
7138,CHI,0,39043891,39044279,388
7139,FC1,1,39044703,39044981,278
7140,FC1,0,39046191,39047120,929
7141,CHI,0,39047227,39047515,288
7142,FC1,0,39048115,39049974,1859
7143,FA1,8,39050517,39051616,1099
7144,CHI,0,39051867,39053791,1924
7145,FC1,0,39054532,39055171,639
7146,CHI,0,39055147,39058251,3104
7147,FC1,0,39059972,39062092,2120
7148,CHI,0,39060739,39061251,512
7149,CHI,0,39062727,39063319,592
7150,CHI,0,39065067,39065471,404
7151,FA1,1,39066483,39069371,2888
7152,CHI,0,39066575,39070871,4296
7153,CHI,0,39071907,39073667,1760
7154,FA1,2,39074786,39076062,1276
7155,FA1,1,39076503,39077695,1192
7156,CHI,0,39076927,39078035,1108
7157,CHI,0,39082687,39083027,340
7158,FA1,4,39082692,39084530,1838
7159,CHI,0,39084103,39084595,492
7160,FC1,0,39084201,39087095,2894
7161,CHI,0,39087151,39089571,2420
7162,FC1,0,39089603,39090378,775
7163,CHI,0,39090407,39091283,876
7164,FC1,0,39091360,39092135,775
7165,FC1,0,39092725,39095719,2994
7166,FA1,1,39096307,39096831,524
7167,FA1,1,39098038,39098625,587
7168,FA1,6,39098980,39099963,983
7169,FA1,14,39100553,39102621,2068
7170,FC1,0,39102774,39105620,2846
7171,FA1,1,39105638,39107088,1450
7172,CHI,0,39106963,39108551,1588
7173,FC1,0,39108866,39109708,842
7174,CHI,0,39109423,39110383,960
7175,FA1,1,39110698,39111399,701
7176,FA1,1,39113886,39114860,974
7177,CHI,0,39115347,39119803,4456
7178,FA1,6,39121588,39123795,2207
7179,CHI,0,39123807,39125175,1368
7180,FA1,3,39125464,39127320,1856
7181,FA1,2,39128411,39129199,788
7182,FA1,1,39129356,39130022,666
7183,FA1,4,39130417,39132047,1630
7184,CHI,0,39132859,39136447,3588
7185,FC1,0,39132859,39136447,3588
7186,FA1,4,39136815,39137725,910
7187,FC1,0,39137694,39142099,4405
7188,FA1,6,39139923,39142121,2198
7189,FC1,0,39142426,39145228,2802
7190,FA1,10,39143512,39146485,2973
7191,FC1,0,39147971,39148511,540
7192,FA1,8,39149417,39151724,2307
7193,FA1,3,39151759,39152255,496
7194,FA1,4,39153079,39153799,720
7195,FA1,6,39155155,39156695,1540
7196,CHI,0,39156915,39157159,244
7197,FA1,6,39157190,39158370,1180
7198,FA1,11,39158627,39160483,1856
7199,FC1,4,39160933,39163708,2775
7200,FA1,11,39164021,39165660,1639
7201,FC1,3,39165786,39167858,2072
7202,FA1,11,39167831,39170309,2478
7203,FA1,8,39172348,39175158,2810
7204,FA1,8,39176641,39178451,1810
7205,FA1,8,39179340,39181031,1691
7206,FA1,10,39181491,39185563,4072
7207,CHI,0,39183131,39188599,5468
7208,FA1,0,39190227,39190624,397
7209,CHI,0,39190851,39191131,280
7210,FA1,0,39191427,39191915,488
7211,FA1,8,39192397,39194775,2378
7212,CHI,0,39193023,39193303,280
7213,CHI,0,39194303,39194679,376
7214,CHI,0,39195247,39195491,244
7215,FA1,3,39195496,39196095,599
7216,CHI,0,39196147,39196319,172
7217,FA1,3,39196672,39197257,585
7218,CHI,0,39196715,39197339,624
7219,FA1,3,39198297,39199009,712
7220,FA1,2,39200401,39200770,369
7221,FA1,2,39201973,39202414,441
7222,FA1,3,39204022,39204743,721
7223,FA1,1,39206353,39207641,1288
7224,FC1,4,39207366,39208772,1406
7225,CHI,0,39209411,39209835,424
7226,FA1,0,39209637,39210384,747
7227,CHI,0,39210859,39213303,2444
7228,FA1,2,39211691,39212275,584
7229,FA1,7,39213628,39215033,1405
7230,FA1,2,39215411,39215600,189
7231,CHI,0,39215771,39216491,720
7232,FA1,2,39216604,39217115,511
7233,CHI,0,39217275,39217663,388
7234,FA1,1,39218023,39218279,256
7235,CHI,0,39218663,39219319,656
7236,FA1,2,39218943,39219826,883
7237,FA1,2,39221813,39222315,502
7238,FA1,6,39223588,39225498,1910
7239,CHI,0,39225347,39227787,2440
7240,FA1,0,39226387,39227216,829
7241,FA1,10,39228179,39230743,2564
7242,CHI,0,39231771,39232447,676
7243,CHI,0,39234131,39241527,7396
7244,FA1,3,39236780,39237376,596
7245,FA1,3,39238351,39239169,818
7246,FA1,1,39240231,39241124,893
7247,CHI,0,39242311,39243187,876
7248,FA1,1,39243475,39244455,980
7249,FA1,1,39245930,39246339,409
7250,CHI,0,39248143,39250867,2724
7251,FA1,3,39249187,39250154,967
7252,FA1,3,39250929,39251710,781
7253,CHI,0,39251619,39253627,2008
7254,FA1,5,39255207,39256869,1662
7255,CHI,0,39256291,39257907,1616
7256,CHI,0,39259403,39261463,2060
7257,CHI,0,39262463,39263679,1216
7258,FA1,1,39263788,39264622,834
7259,CHI,0,39264639,39268979,4340
7260,CHI,0,39270023,39271619,1596
7261,FC1,0,39272505,39275271,2766
7262,FA1,6,39274250,39275217,967
7263,FA1,1,39275720,39276230,510
7264,CHI,0,39276395,39276879,484
7265,FA1,2,39278475,39279005,530
7266,CHI,0,39279435,39282455,3020
7267,FC1,0,39281098,39283144,2046
7268,FA1,2,39283327,39284996,1669
7269,FC1,0,39286039,39287270,1231
7270,CHI,0,39289795,39290735,940
7271,CHI,0,39292271,39295447,3176
7272,FA1,6,39293636,39294940,1304
7273,FA1,12,39294987,39298771,3784
7274,CHI,0,39296019,39298839,2820
7275,CHI,0,39299683,39312195,12512
7276,FA1,10,39299710,39303455,3745
7277,FC1,1,39302613,39303582,969
7278,FC1,1,39304611,39305493,882
7279,FA1,9,39305431,39308729,3298
7280,FA1,10,39309040,39311462,2422
7281,CHI,0,39312695,39317127,4432
7282,FA1,8,39315116,39317531,2415
7283,FA1,0,39318896,39320615,1719
7284,FC1,0,39322399,39323837,1438
7285,FA1,1,39323250,39323713,463
7286,FC1,2,39324333,39324911,578
7287,CHI,0,39325267,39327839,2572
7288,FA1,1,39326531,39327200,669
7289,FA1,1,39329229,39330436,1207
7290,FC1,0,39331940,39333254,1314
7291,FA1,20,39332595,39337367,4772
7292,FC1,0,39335803,39338406,2603
7293,CHI,0,39337331,39338539,1208
7294,FA1,1,39338522,39338911,389
7295,CHI,0,39339167,39339507,340
7296,FC1,0,39339167,39339507,340
7297,FA1,2,39339876,39340463,587
7298,CHI,0,39340887,39341159,272
7299,FA1,18,39341178,39344491,3313
7300,FA1,5,39344996,39346399,1403
7301,FA1,6,39347090,39348238,1148
7302,FC1,2,39347590,39349780,2190
7303,FA1,2,39349958,39351388,1430
7304,FC1,2,39351343,39353202,1859
7305,FA1,6,39354283,39357423,3140
7306,FC1,0,39357415,39360771,3356
7307,CHI,0,39358987,39359339,352
7308,FC1,0,39361383,39363102,1719
7309,FA1,3,39363223,39364217,994
7310,CHI,0,39363571,39366447,2876
7311,FA1,12,39371310,39375447,4137
7312,FA1,7,39376143,39378713,2570
7313,FC1,3,39377081,39379023,1942
7314,CHI,0,39378703,39379447,744
7315,FA1,5,39379823,39380583,760
7316,CHI,0,39380967,39381175,208
7317,FA1,6,39381661,39382818,1157
7318,CHI,0,39383431,39386367,2936
7319,FA1,3,39385000,39386099,1099
7320,FA1,17,39386558,39390260,3702
7321,CHI,0,39388679,39391291,2612
7322,FA1,6,39391283,39392631,1348
7323,CHI,0,39393927,39394811,884
7324,FC1,3,39396285,39397607,1322
7325,FA1,4,39397859,39398709,850
7326,FA1,2,39398714,39400284,1570
7327,FA1,5,39402313,39403577,1264
7328,FA1,4,39403673,39404599,926
7329,FA1,13,39406151,39408935,2784
7330,FA1,1,39409325,39409959,634
7331,FA1,6,39412145,39413733,1588
7332,CHI,0,39417639,39426311,8672
7333,FA1,0,39425198,39427724,2526
7334,CHI,0,39427039,39427672,633
7335,CHI,0,39428051,39429871,1820
7336,FA1,6,39429105,39431275,2170
7337,FA1,4,39432966,39434278,1312
7338,FA1,7,39435691,39437939,2248
7339,CHI,0,39437923,39439079,1156
7340,FA1,1,39439778,39440281,503
7341,CHI,0,39441207,39442035,828
7342,FA1,6,39442102,39442960,858
7343,FA1,12,39443210,39445416,2206
7344,CHI,0,39444887,39448767,3880
7345,FA1,6,39445767,39448051,2284
7346,FA1,2,39448977,39450105,1128
7347,FA1,14,39452472,39455614,3142
7348,FC1,3,39455791,39457430,1639
7349,FA1,1,39457461,39458007,546
7350,CHI,0,39459495,39460859,1364
7351,FA1,4,39459645,39460829,1184
7352,CHI,0,39462971,39463823,852
7353,FA1,1,39463946,39464279,333
7354,CHI,0,39464531,39464767,236
7355,FA1,1,39466818,39467179,361
7356,FA1,22,39470185,39474447,4262
7357,CHI,0,39474667,39477439,2772
7358,FA1,7,39476092,39477780,1688
7359,FC1,0,39476510,39477652,1142
7360,FA1,3,39477960,39478599,639
7361,FC1,1,39479227,39479695,468
7362,FA1,14,39480050,39482589,2539
7363,FC1,1,39482567,39483106,539
7364,FA1,1,39483448,39484018,570
7365,FA1,19,39487642,39492119,4477
7366,FC1,3,39492238,39492926,688
7367,FC1,5,39493649,39494682,1033
7368,FA1,10,39494536,39496980,2444
7369,FC1,2,39497891,39498772,881
7370,FA1,5,39498987,39499947,960
7371,CHI,0,39509283,39509711,428
7372,FA1,3,39510147,39511143,996
7373,FA1,5,39518752,39520518,1766
7374,FA1,11,39534675,39538115,3440
7375,FC1,1,39542540,39543530,990
7376,FA1,9,39544235,39546426,2191
7377,FA1,6,39548257,39550279,2022
7378,FA1,9,39560703,39562937,2234
7379,FA1,1,39567847,39568351,504
7380,FC1,0,39598442,39599996,1554
7381,FA1,3,39601068,39601940,872
7382,FC1,0,39601956,39602675,719
7383,FA1,6,39603667,39604703,1036
7384,FC1,0,39604616,39604888,272
7385,FC1,3,39605596,39606982,1386
7386,FA1,7,39607161,39608355,1194
7387,FA1,2,39628091,39628774,683
7388,FA1,1,39629643,39630072,429
7389,FA1,18,39630926,39634491,3565
7390,FC1,1,39634829,39635183,354
7391,FA1,11,39642633,39645112,2479
7392,FA1,16,39647304,39650127,2823
7393,FC1,1,39655580,39655984,404
7394,FA1,1,39656335,39656558,223
7395,FC1,5,39660103,39662588,2485
7396,FA1,6,39663569,39665084,1515
7397,FA1,1,39665598,39666294,696
7398,FA1,21,39667309,39675559,8250
7399,FA1,6,39677982,39678950,968
7400,FC1,4,39679190,39681063,1873
7401,CHI,0,39680096,39680616,520
7402,FA1,3,39681916,39682339,423
7403,FC1,3,39682535,39683720,1185
7404,FA1,11,39684533,39686603,2070
7405,FC1,3,39687367,39688851,1484
7406,FA1,7,39688196,39689771,1575
7407,FC1,3,39689891,39691055,1164
7408,FA1,7,39691344,39692872,1528
7409,FC1,3,39693275,39694462,1187
7410,FA1,3,39698390,39699883,1493
7411,FA1,13,39700920,39704260,3340
7412,FA1,2,39705923,39706377,454
7413,FA1,7,39706759,39709076,2317
7414,FC1,3,39706759,39709076,2317
7415,FA1,10,39710266,39712545,2279
7416,FC1,3,39713070,39714144,1074
7417,FA1,6,39714291,39716371,2080
7418,FA1,3,39716511,39717391,880
7419,FA1,5,39718991,39720500,1509
7420,FA1,2,39722955,39723725,770
7421,FC1,5,39726743,39728893,2150
7422,FA1,4,39727940,39729368,1428
7423,FA1,9,39731940,39734200,2260
7424,FA1,13,39734521,39738771,4250
7425,FC1,3,39739329,39740003,674
7426,FA1,7,39741326,39742247,921
7427,FC1,8,39743837,39746408,2571
7428,FA1,4,39746852,39747951,1099
7429,FC1,7,39748747,39751523,2776
7430,FA1,8,39751384,39753279,1895
7431,FC1,1,39753033,39753319,286
7432,FA1,5,39754224,39755565,1341
7433,FC1,9,39755604,39759654,4050
7434,CHI,0,39757760,39758427,667
7435,FA1,3,39760055,39760763,708
7436,CHI,0,39760091,39760783,692
7437,FC1,6,39761421,39763399,1978
7438,FA1,9,39763697,39765405,1708
7439,FA1,14,39770520,39773184,2664
7440,FA1,12,39773580,39775536,1956
7441,FA1,16,39775582,39779762,4180
7442,FC1,1,39780039,39781360,1321
7443,FA1,13,39782713,39785367,2654
7444,FA1,23,39787467,39794867,7400
7445,FC1,2,39795639,39796073,434
7446,FA1,2,39796595,39797092,497
7447,FC1,2,39797588,39798141,553
7448,FA1,2,39798179,39798577,398
7449,FC1,2,39798993,39799291,298
7450,FA1,2,39799564,39799894,330
7451,FA1,0,39814253,39814565,312
7452,FA1,7,39820919,39822733,1814
7453,FC1,5,39830310,39835019,4709
7454,FA1,3,39835608,39836666,1058
7455,FC1,0,39837050,39839764,2714
7456,FA1,10,39840036,39842203,2167
7457,FA1,3,39842890,39843554,664
7458,FC1,1,39845548,39846169,621
7459,FA1,9,39845884,39849014,3130
7460,FC1,1,39848845,39849280,435
7461,FA1,7,39849870,39852411,2541
7462,FA1,35,39853069,39861839,8770
7463,FA1,7,39862307,39863711,1404
7464,FA1,9,39863748,39865779,2031
7465,FC1,4,39865856,39867327,1471
7466,FA1,7,39867210,39868595,1385
7467,FC1,0,39870557,39871798,1241
7468,FA1,2,39871949,39873400,1451
7469,FA1,5,39873914,39876423,2509
7470,FC1,0,39876904,39877833,929
7471,FA1,1,39878633,39878861,228
7472,FC1,0,39878998,39879941,943
7473,FA1,14,39880787,39883955,3168
7474,FC1,4,39883951,39884914,963
7475,FA1,6,39885925,39887367,1442
7476,CHI,0,39888311,39888667,356
7477,FA1,5,39892259,39893491,1232
7478,FC1,2,39893283,39895349,2066
7479,FA1,1,39895814,39896014,200
7480,FC1,0,39896128,39898049,1921
7481,FA1,10,39898207,39900352,2145
7482,FA1,3,39900694,39901885,1191
7483,CHI,0,39910603,39910791,188
7484,FA1,9,39910975,39912915,1940
7485,FA1,7,39916889,39918262,1373
7486,FA1,6,39919948,39921480,1532
7487,CHI,0,39921787,39922055,268
7488,FA1,2,39922795,39923646,851
7489,FC1,1,39923975,39924178,203
7490,FA1,1,39927975,39928078,103
7491,FA1,7,39935282,39937019,1737
7492,FA1,6,39938346,39939802,1456
7493,FA1,4,39940659,39941219,560
7494,FC1,1,39942088,39942370,282
7495,FA1,6,39946431,39947506,1075
7496,FA1,4,39948142,39949241,1099
7497,FC1,1,39949667,39950082,415
7498,FA1,6,39956010,39957039,1029
7499,FA1,6,39958256,39959273,1017
7500,FC1,0,39958681,39959332,651
7501,FC1,2,39959873,39961010,1137
7502,FA1,1,39961382,39961669,287
7503,CHI,0,39962143,39962415,272
7504,CHI,0,39963519,39963811,292
7505,FA1,3,39965545,39966761,1216
7506,FC1,0,39967278,39967950,672
7507,FC1,1,39969026,39969497,471
7508,FC1,0,39970829,39971974,1145
7509,CHI,0,39980327,39982071,1744
7510,CHI,0,39982467,39983419,952
7511,CHI,0,39983567,39984337,770
7512,FA1,8,39984456,39986074,1618
7513,FA1,3,39986595,39987699,1104
7514,FA1,5,39989876,39990913,1037
7515,CHI,0,40011379,40011527,148
7516,CHI,0,40021667,40021775,108
7517,CHI,0,40069423,40069559,136
7518,CHI,0,40083497,40083696,199
7519,FA1,2,40095431,40095788,357
7520,FA1,1,40097235,40098115,880
7521,FA1,8,40099604,40100895,1291
7522,FA1,0,40101676,40102776,1100
7523,FA1,1,40103751,40103871,120
7524,FA1,15,40104404,40107827,3423
7525,FA1,13,40108568,40110095,1527
7526,FA1,1,40111013,40111239,226
7527,FA1,2,40127459,40127720,261
7528,FA1,5,40129783,40130858,1075
7529,FA1,1,40136431,40136564,133
7530,FA1,13,40138293,40140223,1930
7531,CHI,0,40141855,40142403,548
7532,FA1,5,40143305,40144089,784
7533,CHI,0,40144039,40144559,520
7534,FA1,7,40149613,40151290,1677
7535,FA1,9,40156620,40158959,2339
7536,CHI,0,40160871,40161287,416
7537,FA1,4,40174902,40175610,708
7538,FA1,4,40176409,40178018,1609
7539,FA1,3,40181802,40182143,341
7540,FA1,2,40186584,40187609,1025
7541,CHI,0,40231341,40232099,758
7542,CHI,0,40240167,40240291,124
7543,CHI,0,40242003,40242575,572
7544,FA1,1,40242851,40243163,312
7545,CHI,0,40243151,40243775,624
7546,FA1,1,40244363,40244547,184
7547,CHI,0,40244515,40244823,308
7548,CHI,0,40245751,40246059,308
7549,FA1,1,40246619,40246831,212
7550,CHI,0,40249259,40249415,156
7551,CHI,0,40250927,40251131,204
7552,CHI,0,40256099,40256651,552
7553,CHI,0,40257195,40257503,308
7554,FA1,6,40258599,40260513,1914
7555,FA1,5,40260578,40261619,1041
7556,CHI,0,40262035,40262615,580
7557,FA1,7,40262959,40264975,2016
7558,CHI,0,40264875,40265183,308
7559,FA1,5,40265851,40267143,1292
7560,CHI,0,40267519,40268603,1084
7561,FA1,5,40268332,40269486,1154
7562,FA1,8,40271099,40272317,1218
7563,CHI,0,40275311,40275475,164
7564,CHI,0,40282391,40282779,388
7565,CHI,0,40283711,40284003,292
7566,FA1,1,40284298,40284607,309
7567,FA1,2,40287430,40288242,812
7568,FA1,12,40288692,40291488,2796
7569,CHI,0,40291419,40291823,404
7570,FA1,1,40292289,40292991,702
7571,CHI,0,40294147,40295087,940
7572,FA1,4,40295424,40297178,1754
7573,FA1,1,40298185,40298714,529
7574,FA1,3,40299492,40301655,2163
7575,CHI,0,40301299,40301659,360
7576,CHI,0,40303099,40303587,488
7577,FA1,1,40303995,40304493,498
7578,CHI,0,40329487,40329795,308
7579,CHI,0,40336979,40337587,608
7580,CHI,0,40344155,40344911,756
7581,CHI,0,40358543,40359271,728
7582,CHI,0,40363031,40363899,868
7583,CHI,0,40369703,40369891,188
7584,CHI,0,40372263,40372427,164
7585,CHI,0,40375811,40376211,400
7586,FA1,1,40377137,40377687,550
7587,FA1,5,40380320,40381618,1298
7588,FA1,0,40382790,40383690,900
7589,FA1,3,40387359,40388354,995
7590,CHI,0,40388627,40389995,1368
7591,FA1,4,40390394,40391609,1215
7592,CHI,0,40392099,40392763,664
7593,FA1,1,40393081,40393479,398
7594,CHI,0,40393403,40394063,660
7595,CHI,0,40394167,40394555,388
7596,FA1,3,40394933,40396067,1134
7597,FA1,1,40397024,40397281,257
7598,CHI,0,40397267,40397815,548
7599,FA1,0,40399144,40399448,304
7600,FA1,6,40403503,40405351,1848
7601,FA1,1,40406173,40406529,356
7602,FA1,6,40407494,40408814,1320
7603,FA1,2,40409723,40412883,3160
7604,FC1,0,40413545,40414813,1268
7605,FA1,3,40416238,40418538,2300
7606,FC1,1,40418900,40419329,429
7607,FA1,6,40419423,40421053,1630
7608,FA1,6,40421623,40423791,2168
7609,FA1,3,40425327,40426299,972
7610,CHI,0,40427143,40427643,500
7611,FA1,1,40427924,40428228,304
7612,CHI,0,40429231,40429955,724
7613,FA1,7,40430069,40431240,1171
7614,CHI,0,40431263,40431687,424
7615,FA1,1,40431914,40432168,254
7616,CHI,0,40440027,40440275,248
7617,FA1,1,40440637,40440825,188
7618,CHI,0,40441899,40442207,308
7619,FA1,1,40442997,40443179,182
7620,CHI,0,40446103,40446379,276
7621,FA1,4,40447062,40447653,591
7622,FA1,2,40450147,40450501,354
7623,FA1,9,40452381,40453939,1558
7624,CHI,0,40454499,40455555,1056
7625,FA1,4,40455754,40456743,989
7626,FA1,4,40457888,40462717,4829
7627,FA1,6,40463409,40468171,4762
7628,CHI,0,40464043,40465363,1320
7629,FA1,0,40469585,40473326,3741
7630,FA1,3,40474297,40478811,4514
7631,CHI,0,40475287,40476931,1644
7632,FA1,4,40479694,40484169,4475
7633,FA1,9,40485060,40490187,5127
7634,FA1,3,40491413,40492197,784
7635,FA1,5,40492999,40494640,1641
7636,FA1,3,40495913,40496548,635
7637,FA1,11,40498496,40501147,2651
7638,FA1,6,40502466,40503676,1210
7639,CHI,0,40504863,40505062,199
7640,FA1,1,40505726,40506751,1025
7641,CHI,0,40508591,40509539,948
7642,FA1,1,40509872,40510082,210
7643,FA1,5,40510822,40511663,841
7644,FC1,3,40512263,40512843,580
7645,FA1,6,40513286,40514355,1069
7646,FA1,4,40514818,40516046,1228
7647,FA1,5,40516672,40517490,818
7648,CHI,0,40517979,40518479,500
7649,CHI,0,40519403,40519835,432
7650,FA1,1,40520894,40521216,322
7651,CHI,0,40521919,40522439,520
7652,FA1,1,40522882,40523198,316
7653,CHI,0,40523567,40523771,204
7654,FA1,1,40524920,40525131,211
7655,CHI,0,40525779,40526047,268
7656,FA1,1,40526913,40527749,836
7657,CHI,0,40529043,40529327,284
7658,FA1,2,40529958,40530590,632
7659,CHI,0,40530795,40531059,264
7660,FA1,1,40531590,40531747,157
7661,CHI,0,40532251,40532463,212
7662,FA1,3,40533409,40533783,374
7663,CHI,0,40533791,40534035,244
7664,FA1,0,40534631,40534965,334
7665,CHI,0,40535643,40535883,240
7666,FA1,1,40536260,40536517,257
7667,CHI,0,40537059,40537351,292
7668,FA1,4,40538803,40539510,707
7669,FA1,0,40540480,40540959,479
7670,FA1,9,40541567,40542777,1210
7671,FA1,0,40542990,40544195,1205
7672,FA1,4,40548808,40549293,485
7673,FA1,0,40559578,40560092,514
7674,FC1,1,40565010,40565296,286
7675,FA1,1,40566012,40566170,158
7676,FA1,4,40606882,40608711,1829
7677,CHI,0,40611351,40611487,136
7678,CHI,0,40612187,40612451,264
7679,CHI,0,40617527,40618131,604
7680,FA1,3,40620675,40621163,488
7681,FA1,1,40627924,40628129,205
7682,FA1,1,40629997,40630125,128
7683,FA1,3,40633385,40633935,550
7684,FA1,3,40637758,40638337,579
7685,CHI,0,40703959,40704163,204
7686,FA1,0,40705455,40705903,448
7687,FA1,0,40720307,40721506,1199
7688,FA1,0,40723989,40724845,856
7689,FA1,1,40727226,40727486,260
7690,CHI,0,40757539,40757731,192
7691,FA1,1,40759586,40760205,619
7692,CHI,0,40761383,40761759,376
7693,FA1,0,40763282,40763514,232
7694,FA1,3,40764452,40766518,2066
7695,FA1,0,40767991,40768980,989
7696,FA1,0,40769641,40770038,397
7697,FA1,0,40772423,40772539,116
7698,CHI,0,40795699,40795971,272
7699,FA1,1,40796600,40797224,624
7700,CHI,0,40802459,40802695,236
7701,FA1,1,40803030,40803329,299
7702,FA1,1,40804643,40805409,766
7703,FA1,1,40822333,40823351,1018
7704,FA1,0,40825220,40826302,1082
7705,CHI,0,40826631,40827047,416
7706,FA1,1,40827135,40827480,345
7707,FA1,5,40828740,40830412,1672
7708,FA1,1,40834224,40835236,1012
7709,FA1,7,40837158,40838099,941
7710,FA1,3,40841463,40843060,1597
7711,FA1,0,40847886,40848447,561
7712,FA1,5,40855143,40856119,976
7713,FA1,1,40856420,40857286,866
7714,FA1,3,40858114,40859119,1005
7715,FC1,0,40858759,40859559,800
7716,FA1,0,40867231,40868149,918
7717,CHI,0,40868479,40869207,728
7718,FA1,0,40875315,40876248,933
7719,FA1,1,40877357,40877720,363
7720,CHI,0,40878043,40878759,716
7721,FA1,1,40879036,40879276,240
7722,FA1,3,40879893,40881483,1590
7723,FA1,3,40884124,40885099,975
7724,CHI,0,40885751,40886363,612
7725,FA1,0,40887202,40887880,678
7726,CHI,0,40887207,40888263,1056
7727,FA1,4,40888424,40889172,748
7728,CHI,0,40889223,40891227,2004
7729,CHI,0,40895083,40895783,700
7730,FA1,3,40895815,40896575,760
7731,FA1,1,40896761,40897598,837
7732,CHI,0,40898591,40899359,768
7733,FA1,1,40899576,40899980,404
7734,CHI,0,40899923,40900675,752
7735,FA1,0,40900720,40901542,822
7736,CHI,0,40900795,40901953,1158
7737,FA1,3,40902330,40902710,380
7738,FA1,0,40907068,40907992,924
7739,FA1,5,40916673,40917727,1054
7740,FA1,8,40919707,40920607,900
7741,CHI,1,40920435,40920791,356
7742,CHI,0,40921054,40925579,4525
7743,FA1,0,40932897,40933330,433
7744,FA1,5,40933680,40936531,2851
7745,FA1,3,40936988,40938207,1219
7746,FC1,5,40937932,40939441,1509
7747,FA1,4,40939446,40940540,1094
7748,FA1,5,40945283,40946189,906
7749,FA1,6,40946426,40947350,924
7750,FA1,3,40951698,40952148,450
7751,FA1,13,40954200,40956668,2468
7752,FA1,2,40961779,40962141,362
7753,FA1,17,40963386,40966087,2701
7754,FA1,5,40967987,40968735,748
7755,FA1,5,40969144,40970115,971
7756,FA1,7,40970281,40971468,1187
7757,FA1,2,40972131,40972488,357
7758,FA1,2,40972970,40973157,187
7759,FA1,3,40974168,40974735,567
7760,FA1,3,40975801,40976228,427
7761,FA1,1,40977692,40978616,924
7762,FA1,12,40979412,40981699,2287
7763,FA1,8,40985752,40987085,1333
7764,FA1,5,40998310,40999367,1057
